,village,year,household,pop_total,pop_M,pop_F
2,莊敬里,2017,2071,5530,2672,2858
3,東榮里,2017,3003,8291,3825,4466
4,三民里,2017,2942,7100,3285,3815
5,新益里,2017,1851,4807,2288,2519
6,富錦里,2017,2131,5422,2496,2926
7,新東里,2017,2001,5154,2433,2721
8,富泰里,2017,2013,4801,2099,2702
9,介壽里,2017,1763,4779,2264,2515
10,精忠里,2017,1755,4628,2150,2478
11,東光里,2017,3025,7349,3442,3907
12,龍田里,2017,4254,11107,5189,5918
13,東昌里,2017,1051,2946,1363,1583
14,東勢里,2017,1813,4586,2144,2442
15,中華里,2017,2554,6759,3159,3600
16,民有里,2017,3491,9063,4180,4883
17,民福里,2017,2668,6537,3100,3437
18,慈祐里,2017,4062,8180,4094,4086
19,安平里,2017,3574,8564,4085,4479
20,鵬程里,2017,2075,5473,2646,2827
21,自強里,2017,3772,10068,4735,5333
22,吉祥里,2017,3435,8743,4071,4672
23,新聚里,2017,3366,8322,3868,4454
24,復盛里,2017,2549,6650,3132,3518
25,中正里,2017,3955,10711,5004,5707
26,中崙里,2017,1722,4513,2107,2406
27,美仁里,2017,1355,3752,1777,1975
28,吉仁里,2017,1557,4224,1980,2244
29,敦化里,2017,2587,7480,3538,3942
30,復源里,2017,1244,3392,1619,1773
31,復建里,2017,1837,4862,2317,2545
32,復勢里,2017,2594,6648,3031,3617
33,福成里,2017,1006,2818,1286,1532
34,松基里,2017,1476,3729,1717,2012
36,西村里,2017,2934,6024,3121,2903
37,正和里,2017,1907,4793,2193,2600
38,興隆里,2017,1263,3000,1396,1604
39,中興里,2017,1753,3689,1637,2052
40,新仁里,2017,1387,3492,1628,1864
41,興雅里,2017,2470,5968,2808,3160
42,敦厚里,2017,2304,5436,2520,2916
43,廣居里,2017,3145,8367,3907,4460
44,安康里,2017,4415,11215,5284,5931
45,六藝里,2017,1407,3930,1910,2020
46,雅祥里,2017,2112,5229,2564,2665
47,五常里,2017,1478,3872,1884,1988
48,五全里,2017,2030,5135,2421,2714
49,永吉里,2017,1437,4166,2102,2064
50,長春里,2017,1700,4351,2100,2251
51,四育里,2017,2189,5749,2810,2939
52,四維里,2017,2167,5531,2640,2891
53,永春里,2017,1972,5088,2472,2616
54,富台里,2017,1958,4548,2126,2422
55,國業里,2017,3022,8169,3881,4288
56,松隆里,2017,888,2346,1154,1192
57,松友里,2017,2545,7184,3398,3786
58,松光里,2017,2084,5039,2434,2605
59,中坡里,2017,1694,4650,2255,2395
60,中行里,2017,2998,8337,4082,4255
61,大道里,2017,2407,6216,3029,3187
62,大仁里,2017,1646,4150,1975,2175
63,景新里,2017,2183,5312,2459,2853
64,惠安里,2017,2640,6786,3273,3513
65,三張里,2017,3658,9204,4422,4782
66,三犁里,2017,2165,5406,2547,2859
67,六合里,2017,2801,6901,3269,3632
68,泰和里,2017,3140,8195,3895,4300
69,景聯里,2017,1916,4725,2234,2491
70,景勤里,2017,1684,4182,2022,2160
71,雙和里,2017,2927,7413,3538,3875
72,嘉興里,2017,1307,3247,1506,1741
73,黎順里,2017,1782,4254,2050,2204
74,黎平里,2017,2994,7296,3420,3876
75,黎忠里,2017,2008,5025,2370,2655
76,黎安里,2017,940,2133,1044,1089
78,德安里,2017,2352,5939,2745,3194
79,仁慈里,2017,2031,5832,2740,3092
80,和安里,2017,2543,7478,3664,3814
81,民炤里,2017,3269,8430,3933,4497
82,仁愛里,2017,2204,5454,2437,3017
83,義村里,2017,2435,5726,2689,3037
84,民輝里,2017,2878,7044,3338,3706
85,昌隆里,2017,1240,3188,1509,1679
86,誠安里,2017,1808,4171,1884,2287
87,光武里,2017,3269,7781,3527,4254
88,龍坡里,2017,2305,6146,2867,3279
89,龍泉里,2017,2036,5098,2344,2754
90,古風里,2017,1799,4334,2038,2296
91,古莊里,2017,3126,7406,3397,4009
92,龍安里,2017,3748,8466,4194,4272
93,錦安里,2017,2372,6485,3013,3472
94,福住里,2017,2395,6894,3154,3740
95,永康里,2017,1502,4055,1927,2128
96,光明里,2017,1425,3889,1880,2009
97,錦泰里,2017,1396,3897,1881,2016
98,錦華里,2017,2180,6228,2938,3290
99,龍圖里,2017,2834,7064,3281,3783
100,新龍里,2017,2639,7184,3348,3836
101,龍陣里,2017,1434,3584,1698,1886
102,龍雲里,2017,1894,4996,2314,2682
103,龍生里,2017,2618,7183,3363,3820
104,住安里,2017,2311,5387,2522,2865
105,義安里,2017,2192,5479,2509,2970
106,通化里,2017,2616,6358,3017,3341
107,通安里,2017,2347,5772,2754,3018
108,臨江里,2017,1765,4294,2026,2268
109,法治里,2017,1867,4604,2151,2453
110,全安里,2017,1847,4549,2103,2446
111,群賢里,2017,2477,6027,2715,3312
112,群英里,2017,2993,7154,3311,3843
113,虎嘯里,2017,1730,3993,1837,2156
114,臥龍里,2017,848,2280,1040,1240
115,龍淵里,2017,3528,10323,4907,5416
116,龍門里,2017,1649,4626,2143,2483
117,大學里,2017,3524,8785,4088,4697
118,芳和里,2017,2317,5897,2850,3047
119,黎元里,2017,2073,5716,2733,2983
120,黎孝里,2017,3059,7832,3729,4103
121,黎和里,2017,2035,4933,2323,2610
122,建安里,2017,2129,5193,2274,2919
123,建倫里,2017,2444,6486,2902,3584
124,敦安里,2017,2493,6697,3054,3643
125,正聲里,2017,1948,5045,2367,2678
126,敦煌里,2017,2412,6629,3042,3587
127,華聲里,2017,1762,4418,2074,2344
128,車層里,2017,2502,6598,3032,3566
129,光信里,2017,3066,8139,3773,4366
130,學府里,2017,1072,2803,1403,1400
132,正守里,2017,1401,3263,1570,1693
133,正義里,2017,2773,5389,2341,3048
134,正得里,2017,2021,3754,1640,2114
135,民安里,2017,2140,4692,2224,2468
136,康樂里,2017,1515,2622,1099,1523
137,中山里,2017,3747,6773,2890,3883
138,聚盛里,2017,2386,4244,1825,2419
139,集英里,2017,3266,7390,3329,4061
140,聚葉里,2017,2012,4076,1841,2235
141,恆安里,2017,2606,5045,2175,2870
142,晴光里,2017,2963,5572,2465,3107
143,圓山里,2017,1972,4387,2016,2371
144,劍潭里,2017,1440,3917,1883,2034
145,大直里,2017,3612,9878,4669,5209
146,成功里,2017,2975,7193,3290,3903
147,永安里,2017,3855,9999,4632,5367
148,大佳里,2017,433,1147,632,515
149,新喜里,2017,2182,5580,2622,2958
150,新庄里,2017,2182,5204,2432,2772
151,新福里,2017,2227,5334,2463,2871
152,松江里,2017,2617,6777,3145,3632
153,新生里,2017,2166,5059,2326,2733
154,中庄里,2017,2332,5286,2521,2765
155,行政里,2017,3901,7697,3961,3736
156,行仁里,2017,3064,8524,4068,4456
157,行孝里,2017,1619,4258,2035,2223
158,下埤里,2017,3011,7777,3654,4123
159,江寧里,2017,2855,7233,3378,3855
160,江山里,2017,3112,7807,3735,4072
161,中吉里,2017,2355,5879,2818,3061
162,中原里,2017,2242,5208,2443,2765
163,興亞里,2017,2483,5427,2514,2913
164,中央里,2017,1569,3884,1815,2069
165,朱馥里,2017,2543,6241,2911,3330
166,龍洲里,2017,2120,5124,2360,2764
167,朱園里,2017,2239,4721,2166,2555
168,埤頭里,2017,1578,3529,1704,1825
169,朱崙里,2017,1334,2908,1316,1592
170,力行里,2017,2719,6175,2890,3285
171,復華里,2017,2151,4831,2204,2627
172,金泰里,2017,3462,8081,3921,4160
173,北安里,2017,1046,2825,1339,1486
175,水源里,2017,1382,3081,1422,1659
176,富水里,2017,1053,2687,1340,1347
177,文盛里,2017,1050,2363,1146,1217
178,林興里,2017,2042,4781,2265,2516
179,河堤里,2017,2002,4710,2257,2453
180,頂東里,2017,2813,6206,2862,3344
181,網溪里,2017,2530,5984,2789,3195
182,板溪里,2017,1508,3380,1583,1797
183,螢圃里,2017,2403,5567,2661,2906
184,螢雪里,2017,1815,4531,2189,2342
185,永功里,2017,2553,6505,3182,3323
186,永昌里,2017,2089,5185,2557,2628
187,龍興里,2017,1610,4456,2168,2288
188,忠勤里,2017,3027,6668,3157,3511
189,廈安里,2017,1822,4881,2335,2546
190,愛國里,2017,1351,3507,1579,1928
191,南門里,2017,1058,2894,1356,1538
192,龍光里,2017,1371,3785,1848,1937
193,南福里,2017,4503,11346,5469,5877
194,龍福里,2017,2477,6417,3082,3335
195,新營里,2017,3590,10148,4903,5245
196,建國里,2017,681,1740,783,957
197,光復里,2017,1835,4000,1876,2124
198,黎明里,2017,1645,3503,1704,1799
199,梅花里,2017,1392,3227,1530,1697
200,幸福里,2017,2894,6018,3067,2951
201,幸市里,2017,1980,4651,2211,2440
202,東門里,2017,1668,4184,2007,2177
203,文北里,2017,2325,5827,2773,3054
204,文祥里,2017,3119,8432,3974,4458
205,三愛里,2017,3519,8944,4119,4825
207,玉泉里,2017,1265,3101,1539,1562
208,建明里,2017,1521,3517,1703,1814
209,建功里,2017,2043,4895,2327,2568
210,建泰里,2017,1658,4032,1949,2083
211,永樂里,2017,2224,5589,2777,2812
212,朝陽里,2017,2007,4554,2181,2373
213,星明里,2017,2620,6432,3049,3383
214,光能里,2017,2009,5399,2611,2788
215,大有里,2017,1925,5114,2501,2613
216,延平里,2017,1862,4350,2102,2248
217,雙連里,2017,3784,10102,4921,5181
218,南芳里,2017,1668,4255,1985,2270
219,民權里,2017,2603,6902,3309,3593
220,景星里,2017,1170,2868,1411,1457
221,隆和里,2017,1225,3252,1586,1666
222,蓬萊里,2017,2079,5101,2480,2621
223,國順里,2017,1125,2929,1539,1390
224,國慶里,2017,1857,4582,2161,2421
225,揚雅里,2017,2256,4460,2393,2067
226,斯文里,2017,2330,5569,2762,2807
227,鄰江里,2017,2624,6668,3351,3317
228,至聖里,2017,3384,8348,3998,4350
229,老師里,2017,2345,6177,3083,3094
230,重慶里,2017,2526,6840,3271,3569
231,保安里,2017,1680,4242,2073,2169
233,福星里,2017,2714,5709,2709,3000
234,萬壽里,2017,1883,3507,1687,1820
235,西門里,2017,2026,3918,1799,2119
236,新起里,2017,3022,6685,3132,3553
237,菜園里,2017,2708,6271,3140,3131
238,青山里,2017,2648,5889,2911,2978
239,富民里,2017,2188,5057,2458,2599
240,福音里,2017,1779,4101,2003,2098
241,仁德里,2017,2165,4939,2378,2561
242,富福里,2017,3228,6332,3522,2810
243,頂碩里,2017,2992,7561,3793,3768
244,雙園里,2017,1896,4884,2426,2458
245,新忠里,2017,1553,3511,1679,1832
246,新和里,2017,3412,8626,4119,4507
247,糖?里,2017,2242,5719,2839,2880
248,和平里,2017,2821,7177,3536,3641
249,綠堤里,2017,1753,4500,2194,2306
250,華江里,2017,3255,8890,4340,4550
251,柳鄉里,2017,2114,5462,2726,2736
252,日善里,2017,1436,3898,1936,1962
253,新安里,2017,2649,6392,3168,3224
254,忠德里,2017,1733,4636,2308,2328
255,孝德里,2017,1281,3469,1725,1744
256,和德里,2017,2730,7354,3677,3677
257,錦德里,2017,2181,5795,2833,2962
258,全德里,2017,1744,4644,2319,2325
259,保德里,2017,1297,3548,1752,1796
260,銘德里,2017,1849,4866,2362,2504
261,榮德里,2017,1386,3780,1893,1887
262,壽德里,2017,1995,5453,2687,2766
263,興德里,2017,1772,5020,2471,2549
264,華中里,2017,2446,6521,3171,3350
265,日祥里,2017,2451,5748,2792,2956
266,忠貞里,2017,2287,4960,2376,2584
267,凌霄里,2017,1667,3848,1818,2030
268,騰雲里,2017,1330,3180,1555,1625
270,景行里,2017,3266,7953,3726,4227
271,景東里,2017,2942,7735,3611,4124
272,景美里,2017,2056,5504,2595,2909
273,景慶里,2017,2550,6994,3354,3640
274,景仁里,2017,1968,5195,2490,2705
275,景華里,2017,2261,6072,2846,3226
276,萬有里,2017,2204,5889,2828,3061
277,萬祥里,2017,1848,4686,2210,2476
278,萬隆里,2017,2897,7647,3602,4045
279,萬年里,2017,2274,5556,2678,2878
280,萬和里,2017,1414,3393,1613,1780
281,萬盛里,2017,2049,4888,2345,2543
282,興豐里,2017,2059,5124,2469,2655
283,興光里,2017,1467,3510,1616,1894
284,興家里,2017,2899,7856,3841,4015
285,興得里,2017,2397,6172,2973,3199
286,興業里,2017,2112,5542,2650,2892
287,興安里,2017,2712,6937,3279,3658
288,興福里,2017,2139,6161,2944,3217
289,興旺里,2017,3430,8700,4190,4510
290,興泰里,2017,1692,4079,1963,2116
291,興昌里,2017,2810,7003,3318,3685
292,試院里,2017,2788,7167,3422,3745
293,華興里,2017,3569,9328,4497,4831
294,明義里,2017,1703,4551,2193,2358
295,明興里,2017,2770,7111,3387,3724
296,木柵里,2017,3543,9190,4336,4854
297,木新里,2017,4491,10562,5328,5234
298,順興里,2017,2930,8062,3891,4171
299,樟林里,2017,3227,8888,4361,4527
300,樟新里,2017,2182,5915,2813,3102
301,樟腳里,2017,2121,6021,2914,3107
302,萬芳里,2017,3162,8313,3915,4398
303,博嘉里,2017,2269,6113,2936,3177
304,萬興里,2017,3268,8846,4305,4541
305,指南里,2017,1724,4098,2125,1973
306,老泉里,2017,366,981,507,474
307,忠順里,2017,1720,4141,1976,2165
308,萬美里,2017,2907,7652,3695,3957
309,政大里,2017,2967,8085,3899,4186
310,樟文里,2017,2326,6513,3199,3314
311,興邦里,2017,2138,5079,2398,2681
312,樟樹里,2017,1863,5212,2478,2734
314,南港里,2017,2764,6653,3419,3234
315,中南里,2017,1511,3983,1972,2011
316,新富里,2017,1586,4244,2118,2126
317,三重里,2017,3503,7664,3724,3940
318,東新里,2017,2770,7625,3729,3896
319,新光里,2017,1534,3965,1890,2075
320,東明里,2017,1904,4931,2410,2521
321,西新里,2017,1849,5049,2486,2563
322,玉成里,2017,2013,5075,2455,2620
323,合成里,2017,2784,7062,3428,3634
324,成福里,2017,2959,7997,3860,4137
325,萬福里,2017,1726,4412,2108,2304
326,鴻福里,2017,1739,4729,2256,2473
327,百福里,2017,2153,5655,2773,2882
328,聯成里,2017,1995,5324,2590,2734
329,舊莊里,2017,3523,9609,4704,4905
330,中研里,2017,3579,9840,4828,5012
331,九如里,2017,2499,6742,3347,3395
332,仁福里,2017,2265,5836,2860,2976
333,重陽里,2017,2396,5760,2748,3012
335,西湖里,2017,2814,7464,3602,3862
336,西康里,2017,3832,9726,4646,5080
337,西安里,2017,2591,6848,3265,3583
338,港墘里,2017,2370,6417,3042,3375
339,港都里,2017,2160,6039,2898,3141
340,港富里,2017,3604,10076,4811,5265
341,港華里,2017,3349,9772,4644,5128
342,內湖里,2017,2602,6159,2831,3328
343,湖濱里,2017,3310,8680,4077,4603
344,紫星里,2017,3051,8314,3998,4316
345,大湖里,2017,2186,5725,2668,3057
346,金龍里,2017,2071,5595,2768,2827
347,金瑞里,2017,2597,7030,3299,3731
348,碧山里,2017,2697,7343,3582,3761
349,紫雲里,2017,2295,6178,2966,3212
350,清白里,2017,3724,8888,4118,4770
351,葫洲里,2017,2736,7922,3775,4147
352,紫陽里,2017,3201,8462,4063,4399
353,瑞陽里,2017,3163,8072,3822,4250
354,瑞光里,2017,1777,4796,2238,2558
355,五分里,2017,4145,11901,5677,6224
356,東湖里,2017,2834,8106,3910,4196
357,樂康里,2017,3173,9203,4422,4781
358,內溝里,2017,1832,5022,2455,2567
359,週美里,2017,3562,8315,4008,4307
360,行善里,2017,2826,7063,3483,3580
361,石潭里,2017,1974,4117,1956,2161
362,湖興里,2017,4067,8935,4443,4492
363,湖元里,2017,2104,5699,2735,2964
364,安湖里,2017,2730,8331,3983,4348
365,秀湖里,2017,2454,6489,3131,3358
366,安泰里,2017,2113,5844,2797,3047
367,金湖里,2017,3931,10601,4936,5665
368,康寧里,2017,3171,9571,4588,4983
369,明湖里,2017,1999,6026,2862,3164
370,蘆洲里,2017,510,1420,765,655
371,麗山里,2017,2318,6385,3035,3350
372,寶湖里,2017,3812,9078,4370,4708
373,南湖里,2017,2231,6159,2861,3298
375,仁勇里,2017,1542,4166,2014,2152
376,義信里,2017,1372,3421,1655,1766
377,福林里,2017,1260,3163,1531,1632
378,福德里,2017,2973,6120,3211,2909
379,福志里,2017,3050,7894,3738,4156
380,舊佳里,2017,2539,6466,3039,3427
381,福佳里,2017,3009,8194,3934,4260
382,後港里,2017,3095,8611,4265,4346
383,福中里,2017,2610,7355,3542,3813
384,前港里,2017,1770,4904,2347,2557
385,百齡里,2017,2550,7577,3698,3879
386,承德里,2017,2367,5823,2735,3088
387,福華里,2017,2581,6642,3200,3442
388,明勝里,2017,1991,5204,2495,2709
389,福順里,2017,2111,5543,2748,2795
390,富光里,2017,2171,6211,3051,3160
391,葫蘆里,2017,2851,8109,3906,4203
392,葫東里,2017,1596,4320,2103,2217
393,社子里,2017,2468,6860,3359,3501
394,社新里,2017,3473,9671,4819,4852
395,社園里,2017,2636,7733,3875,3858
396,永倫里,2017,2763,7587,3797,3790
397,福安里,2017,1841,5009,2673,2336
398,富洲里,2017,2420,6111,3216,2895
399,岩山里,2017,1272,3534,1679,1855
400,名山里,2017,2688,7441,3417,4024
401,德行里,2017,1933,4583,2126,2457
402,德華里,2017,2245,5837,2712,3125
403,聖山里,2017,1965,5352,2530,2822
404,忠誠里,2017,2195,5820,2781,3039
405,芝山里,2017,2777,7943,3797,4146
406,東山里,2017,1814,5372,2601,2771
407,三玉里,2017,2176,6089,2865,3224
408,蘭雅里,2017,3332,9113,4281,4832
409,蘭興里,2017,2476,6767,3175,3592
410,天福里,2017,2349,6664,3109,3555
411,天祿里,2017,1987,5494,2542,2952
412,天壽里,2017,1969,5355,2467,2888
413,天和里,2017,2782,8038,3824,4214
414,天山里,2017,2694,7270,3397,3873
415,天玉里,2017,3521,9416,4352,5064
416,天母里,2017,2592,7090,3336,3754
417,永福里,2017,460,1296,631,665
418,公館里,2017,540,1432,744,688
419,新安里,2017,750,1993,990,1003
420,陽明里,2017,1392,3111,1488,1623
421,菁山里,2017,585,1671,906,765
422,平等里,2017,537,1549,784,765
423,溪山里,2017,566,1540,792,748
424,翠山里,2017,1193,2764,1308,1456
425,臨溪里,2017,1206,3067,1492,1575
427,建民里,2017,1712,4397,2112,2285
428,文林里,2017,1707,4392,2118,2274
429,石牌里,2017,2084,5525,2624,2901
430,福興里,2017,2736,7610,3602,4008
431,榮光里,2017,2808,8067,3829,4238
432,榮華里,2017,2956,7764,3642,4122
433,裕民里,2017,3098,8084,3849,4235
434,振華里,2017,2914,8098,3822,4276
435,永和里,2017,3717,9610,4568,5042
436,永欣里,2017,3470,8311,3861,4450
437,永明里,2017,1890,5308,2492,2816
438,東華里,2017,1647,4748,2214,2534
439,吉利里,2017,2613,7628,3662,3966
440,吉慶里,2017,1969,5764,2723,3041
441,尊賢里,2017,1779,5119,2404,2715
442,立賢里,2017,2055,5913,2826,3087
443,立農里,2017,3408,9647,4627,5020
444,八仙里,2017,2214,5839,2849,2990
445,洲美里,2017,832,2186,1098,1088
446,奇岩里,2017,3902,10321,5044,5277
447,清江里,2017,4258,9751,4966,4785
448,中央里,2017,3403,8975,4289,4686
449,長安里,2017,2675,6468,2980,3488
450,大同里,2017,2372,6186,3035,3151
451,溫泉里,2017,2798,6943,3278,3665
452,林泉里,2017,1454,3185,1547,1638
453,中心里,2017,3094,6680,3099,3581
454,中庸里,2017,1732,4448,2158,2290
455,開明里,2017,2629,6872,3286,3586
456,中和里,2017,1953,5150,2483,2667
457,智仁里,2017,2320,6531,3128,3403
458,秀山里,2017,1230,3423,1678,1745
459,文化里,2017,1666,4524,2176,2348
460,豐年里,2017,1695,4833,2371,2462
461,稻香里,2017,2214,5666,2818,2848
462,桃源里,2017,2344,6318,3080,3238
463,一德里,2017,2836,7838,3855,3983
464,關渡里,2017,4221,11901,5898,6003
465,泉源里,2017,856,2446,1290,1156
466,湖山里,2017,701,1741,899,842
467,大屯里,2017,424,1249,655,594
468,湖田里,2017,383,997,544,453
471,莊敬里,2018,2079,5518,2662,2856
472,東榮里,2018,3022,8299,3830,4469
473,三民里,2018,2946,7114,3290,3824
474,新益里,2018,1855,4804,2287,2517
475,富錦里,2018,2146,5434,2494,2940
476,新東里,2018,2015,5178,2442,2736
477,富泰里,2018,2021,4809,2101,2708
478,介壽里,2018,1775,4798,2268,2530
479,精忠里,2018,1764,4636,2150,2486
480,東光里,2018,3038,7338,3443,3895
481,龍田里,2018,4271,11109,5185,5924
482,東昌里,2018,1056,2949,1365,1584
483,東勢里,2018,1815,4569,2131,2438
484,中華里,2018,2558,6769,3157,3612
485,民有里,2018,3502,9073,4190,4883
486,民福里,2018,2676,6550,3103,3447
487,慈祐里,2018,4059,8161,4088,4073
488,安平里,2018,3603,8593,4102,4491
489,鵬程里,2018,2095,5478,2646,2832
490,自強里,2018,3802,10047,4726,5321
491,吉祥里,2018,3438,8731,4071,4660
492,新聚里,2018,3378,8324,3867,4457
493,復盛里,2018,2560,6656,3134,3522
494,中正里,2018,3959,10738,5021,5717
495,中崙里,2018,1722,4512,2101,2411
496,美仁里,2018,1351,3737,1771,1966
497,吉仁里,2018,1565,4232,1981,2251
498,敦化里,2018,2600,7491,3548,3943
499,復源里,2018,1252,3402,1623,1779
500,復建里,2018,1838,4854,2308,2546
501,復勢里,2018,2601,6659,3043,3616
502,福成里,2018,1004,2812,1284,1528
503,松基里,2018,1483,3733,1721,2012
505,西村里,2018,2933,6007,3108,2899
506,正和里,2018,1907,4787,2191,2596
507,興隆里,2018,1262,2992,1384,1608
508,中興里,2018,1758,3707,1648,2059
509,新仁里,2018,1392,3504,1635,1869
510,興雅里,2018,2468,5947,2800,3147
511,敦厚里,2018,2305,5410,2500,2910
512,廣居里,2018,3147,8366,3905,4461
513,安康里,2018,4422,11220,5282,5938
514,六藝里,2018,1409,3932,1912,2020
515,雅祥里,2018,2122,5239,2568,2671
516,五常里,2018,1474,3853,1868,1985
517,五全里,2018,2029,5136,2417,2719
518,永吉里,2018,1438,4155,2096,2059
519,長春里,2018,1700,4356,2107,2249
520,四育里,2018,2190,5754,2818,2936
521,四維里,2018,2170,5543,2652,2891
522,永春里,2018,1967,5069,2462,2607
523,富台里,2018,1959,4544,2124,2420
524,國業里,2018,3020,8152,3875,4277
525,松隆里,2018,885,2330,1148,1182
526,松友里,2018,2545,7157,3374,3783
527,松光里,2018,2081,5035,2432,2603
528,中坡里,2018,1698,4659,2263,2396
529,中行里,2018,2995,8335,4081,4254
530,大道里,2018,2404,6204,3025,3179
531,大仁里,2018,1645,4139,1971,2168
532,景新里,2018,2184,5320,2464,2856
533,惠安里,2018,2645,6795,3280,3515
534,三張里,2018,3666,9202,4416,4786
535,三犁里,2018,2166,5401,2546,2855
536,六合里,2018,2801,6901,3272,3629
537,泰和里,2018,3141,8192,3895,4297
538,景聯里,2018,1918,4724,2233,2491
539,景勤里,2018,1679,4174,2015,2159
540,雙和里,2018,2930,7412,3532,3880
541,嘉興里,2018,1308,3240,1497,1743
542,黎順里,2018,1783,4239,2039,2200
543,黎平里,2018,2993,7280,3412,3868
544,黎忠里,2018,2004,5009,2364,2645
545,黎安里,2018,939,2140,1047,1093
547,德安里,2018,2349,5929,2743,3186
548,仁慈里,2018,2032,5835,2746,3089
549,和安里,2018,2540,7477,3663,3814
550,民炤里,2018,3268,8427,3930,4497
551,仁愛里,2018,2211,5472,2444,3028
552,義村里,2018,2430,5705,2674,3031
553,民輝里,2018,2878,7044,3338,3706
554,昌隆里,2018,1240,3179,1501,1678
555,誠安里,2018,1807,4172,1886,2286
556,光武里,2018,3274,7791,3536,4255
557,龍坡里,2018,2313,6142,2863,3279
558,龍泉里,2018,2044,5115,2352,2763
559,古風里,2018,1799,4332,2037,2295
560,古莊里,2018,3129,7406,3397,4009
561,龍安里,2018,3756,8486,4202,4284
562,錦安里,2018,2372,6473,3007,3466
563,福住里,2018,2393,6876,3143,3733
564,永康里,2018,1498,4044,1924,2120
565,光明里,2018,1429,3907,1888,2019
566,錦泰里,2018,1399,3898,1882,2016
567,錦華里,2018,2182,6227,2939,3288
568,龍圖里,2018,2828,7039,3268,3771
569,新龍里,2018,2640,7201,3359,3842
570,龍陣里,2018,1434,3587,1697,1890
571,龍雲里,2018,1909,5013,2319,2694
572,龍生里,2018,2619,7183,3365,3818
573,住安里,2018,2314,5396,2521,2875
574,義安里,2018,2189,5459,2500,2959
575,通化里,2018,2608,6337,3007,3330
576,通安里,2018,2340,5760,2748,3012
577,臨江里,2018,1770,4302,2027,2275
578,法治里,2018,1867,4605,2151,2454
579,全安里,2018,1842,4555,2102,2453
580,群賢里,2018,2477,6017,2715,3302
581,群英里,2018,3002,7152,3314,3838
582,虎嘯里,2018,1733,3993,1834,2159
583,臥龍里,2018,850,2275,1035,1240
584,龍淵里,2018,3538,10346,4920,5426
585,龍門里,2018,1647,4617,2136,2481
586,大學里,2018,3513,8766,4075,4691
587,芳和里,2018,2312,5874,2840,3034
588,黎元里,2018,2071,5716,2738,2978
589,黎孝里,2018,3060,7833,3728,4105
590,黎和里,2018,2038,4931,2331,2600
591,建安里,2018,2127,5197,2280,2917
592,建倫里,2018,2448,6490,2904,3586
593,敦安里,2018,2501,6697,3051,3646
594,正聲里,2018,1944,5043,2366,2677
595,敦煌里,2018,2413,6622,3039,3583
596,華聲里,2018,1756,4403,2061,2342
597,車層里,2018,2496,6580,3017,3563
598,光信里,2018,3061,8115,3761,4354
599,學府里,2018,1072,2794,1401,1393
601,正守里,2018,1407,3266,1570,1696
602,正義里,2018,2770,5379,2336,3043
603,正得里,2018,2022,3739,1636,2103
604,民安里,2018,2144,4694,2228,2466
605,康樂里,2018,1512,2627,1104,1523
606,中山里,2018,3734,6759,2881,3878
607,聚盛里,2018,2381,4243,1825,2418
608,集英里,2018,3260,7383,3325,4058
609,聚葉里,2018,2012,4074,1845,2229
610,恆安里,2018,2613,5056,2187,2869
611,晴光里,2018,2957,5559,2459,3100
612,圓山里,2018,1973,4381,2010,2371
613,劍潭里,2018,1447,3921,1888,2033
614,大直里,2018,3614,9864,4654,5210
615,成功里,2018,2979,7184,3290,3894
616,永安里,2018,3854,9978,4619,5359
617,大佳里,2018,433,1144,632,512
618,新喜里,2018,2180,5566,2616,2950
619,新庄里,2018,2185,5212,2439,2773
620,新福里,2018,2239,5354,2472,2882
621,松江里,2018,2610,6762,3153,3609
622,新生里,2018,2169,5051,2324,2727
623,中庄里,2018,2332,5276,2518,2758
624,行政里,2018,3898,7690,3958,3732
625,行仁里,2018,3068,8524,4068,4456
626,行孝里,2018,1623,4247,2031,2216
627,下埤里,2018,3006,7773,3657,4116
628,江寧里,2018,2865,7229,3375,3854
629,江山里,2018,3121,7812,3741,4071
630,中吉里,2018,2357,5876,2818,3058
631,中原里,2018,2239,5211,2447,2764
632,興亞里,2018,2488,5437,2517,2920
633,中央里,2018,1574,3896,1820,2076
634,朱馥里,2018,2537,6223,2904,3319
635,龍洲里,2018,2122,5123,2355,2768
636,朱園里,2018,2233,4689,2153,2536
637,埤頭里,2018,1578,3517,1697,1820
638,朱崙里,2018,1345,2916,1321,1595
639,力行里,2018,2712,6162,2876,3286
640,復華里,2018,2156,4834,2204,2630
641,金泰里,2018,3472,8095,3921,4174
642,北安里,2018,1048,2832,1342,1490
644,水源里,2018,1382,3085,1424,1661
645,富水里,2018,1054,2688,1340,1348
646,文盛里,2018,1052,2361,1145,1216
647,林興里,2018,2048,4802,2276,2526
648,河堤里,2018,2005,4715,2257,2458
649,頂東里,2018,2814,6190,2856,3334
650,網溪里,2018,2519,5973,2783,3190
651,板溪里,2018,1510,3366,1579,1787
652,螢圃里,2018,2405,5577,2669,2908
653,螢雪里,2018,1825,4531,2191,2340
654,永功里,2018,2550,6488,3174,3314
655,永昌里,2018,2088,5185,2556,2629
656,龍興里,2018,1605,4437,2159,2278
657,忠勤里,2018,3026,6669,3152,3517
658,廈安里,2018,1830,4907,2348,2559
659,愛國里,2018,1357,3522,1593,1929
660,南門里,2018,1062,2912,1366,1546
661,龍光里,2018,1377,3792,1853,1939
662,南福里,2018,4513,11358,5473,5885
663,龍福里,2018,2478,6415,3077,3338
664,新營里,2018,3595,10149,4906,5243
665,建國里,2018,682,1741,783,958
666,光復里,2018,1832,3996,1876,2120
667,黎明里,2018,1640,3480,1692,1788
668,梅花里,2018,1391,3212,1521,1691
669,幸福里,2018,2889,6006,3058,2948
670,幸市里,2018,1977,4644,2208,2436
671,東門里,2018,1671,4194,2012,2182
672,文北里,2018,2320,5811,2765,3046
673,文祥里,2018,3124,8448,3980,4468
674,三愛里,2018,3521,8944,4111,4833
676,玉泉里,2018,1270,3113,1549,1564
677,建明里,2018,1524,3521,1702,1819
678,建功里,2018,2043,4886,2328,2558
679,建泰里,2018,1665,4051,1956,2095
680,永樂里,2018,2227,5570,2770,2800
681,朝陽里,2018,2001,4548,2181,2367
682,星明里,2018,2620,6432,3050,3382
683,光能里,2018,2013,5410,2615,2795
684,大有里,2018,1923,5102,2497,2605
685,延平里,2018,1864,4342,2099,2243
686,雙連里,2018,3794,10107,4918,5189
687,南芳里,2018,1677,4268,1991,2277
688,民權里,2018,2604,6902,3308,3594
689,景星里,2018,1167,2858,1406,1452
690,隆和里,2018,1220,3238,1579,1659
691,蓬萊里,2018,2081,5112,2493,2619
692,國順里,2018,1119,2906,1528,1378
693,國慶里,2018,1860,4591,2164,2427
694,揚雅里,2018,2263,4464,2394,2070
695,斯文里,2018,2329,5559,2757,2802
696,鄰江里,2018,2621,6665,3346,3319
697,至聖里,2018,3376,8332,3991,4341
698,老師里,2018,2341,6161,3073,3088
699,重慶里,2018,2530,6838,3269,3569
700,保安里,2018,1677,4232,2065,2167
702,福星里,2018,2716,5705,2700,3005
703,萬壽里,2018,1879,3498,1685,1813
704,西門里,2018,2019,3909,1801,2108
705,新起里,2018,3022,6678,3137,3541
706,菜園里,2018,2699,6250,3132,3118
707,青山里,2018,2649,5896,2910,2986
708,富民里,2018,2184,5047,2457,2590
709,福音里,2018,1777,4078,1990,2088
710,仁德里,2018,2162,4930,2372,2558
711,富福里,2018,3236,6338,3522,2816
712,頂碩里,2018,2985,7536,3786,3750
713,雙園里,2018,1897,4896,2429,2467
714,新忠里,2018,1560,3517,1687,1830
715,新和里,2018,3412,8624,4130,4494
716,糖?里,2018,2246,5734,2856,2878
717,和平里,2018,2826,7189,3531,3658
718,綠堤里,2018,1751,4506,2196,2310
719,華江里,2018,3266,8909,4355,4554
720,柳鄉里,2018,2110,5463,2729,2734
721,日善里,2018,1437,3890,1938,1952
722,新安里,2018,2651,6399,3171,3228
723,忠德里,2018,1730,4618,2291,2327
724,孝德里,2018,1275,3458,1725,1733
725,和德里,2018,2723,7317,3657,3660
726,錦德里,2018,2186,5807,2843,2964
727,全德里,2018,1747,4657,2322,2335
728,保德里,2018,1298,3547,1749,1798
729,銘德里,2018,1848,4870,2358,2512
730,榮德里,2018,1386,3773,1891,1882
731,壽德里,2018,2000,5469,2693,2776
732,興德里,2018,1770,5019,2463,2556
733,華中里,2018,2443,6507,3163,3344
734,日祥里,2018,2456,5740,2786,2954
735,忠貞里,2018,2287,4953,2370,2583
736,凌霄里,2018,1663,3841,1811,2030
737,騰雲里,2018,1334,3179,1556,1623
739,景行里,2018,3273,7959,3736,4223
740,景東里,2018,2941,7729,3611,4118
741,景美里,2018,2057,5512,2598,2914
742,景慶里,2018,2550,6997,3353,3644
743,景仁里,2018,1988,5234,2508,2726
744,景華里,2018,2270,6104,2849,3255
745,萬有里,2018,2212,5904,2832,3072
746,萬祥里,2018,1854,4691,2216,2475
747,萬隆里,2018,2898,7633,3599,4034
748,萬年里,2018,2273,5551,2678,2873
749,萬和里,2018,1418,3401,1619,1782
750,萬盛里,2018,2045,4852,2327,2525
751,興豐里,2018,2061,5133,2476,2657
752,興光里,2018,1465,3510,1616,1894
753,興家里,2018,2903,7848,3834,4014
754,興得里,2018,2402,6162,2963,3199
755,興業里,2018,2109,5534,2649,2885
756,興安里,2018,2726,6955,3285,3670
757,興福里,2018,2145,6164,2946,3218
758,興旺里,2018,3431,8696,4180,4516
759,興泰里,2018,1692,4073,1957,2116
760,興昌里,2018,2806,7011,3319,3692
761,試院里,2018,2784,7148,3418,3730
762,華興里,2018,3574,9311,4487,4824
763,明義里,2018,1694,4533,2183,2350
764,明興里,2018,2781,7122,3395,3727
765,木柵里,2018,3550,9185,4335,4850
766,木新里,2018,4491,10558,5321,5237
767,順興里,2018,2929,8069,3890,4179
768,樟林里,2018,3228,8888,4355,4533
769,樟新里,2018,2187,5918,2810,3108
770,樟腳里,2018,2117,6012,2912,3100
771,萬芳里,2018,3161,8281,3905,4376
772,博嘉里,2018,2267,6102,2927,3175
773,萬興里,2018,3273,8847,4303,4544
774,指南里,2018,1728,4116,2130,1986
775,老泉里,2018,366,979,506,473
776,忠順里,2018,1722,4137,1973,2164
777,萬美里,2018,2908,7650,3693,3957
778,政大里,2018,2962,8080,3895,4185
779,樟文里,2018,2336,6526,3207,3319
780,興邦里,2018,2136,5075,2397,2678
781,樟樹里,2018,1860,5189,2466,2723
783,南港里,2018,2764,6640,3410,3230
784,中南里,2018,1510,3988,1976,2012
785,新富里,2018,1583,4245,2120,2125
786,三重里,2018,3505,7697,3747,3950
787,東新里,2018,2780,7641,3736,3905
788,新光里,2018,1531,3954,1881,2073
789,東明里,2018,1907,4929,2413,2516
790,西新里,2018,1857,5060,2489,2571
791,玉成里,2018,2009,5069,2458,2611
792,合成里,2018,2786,7055,3431,3624
793,成福里,2018,2961,7993,3846,4147
794,萬福里,2018,1734,4422,2113,2309
795,鴻福里,2018,1737,4727,2257,2470
796,百福里,2018,2150,5652,2766,2886
797,聯成里,2018,2001,5334,2597,2737
798,舊莊里,2018,3516,9587,4699,4888
799,中研里,2018,3576,9823,4817,5006
800,九如里,2018,2499,6749,3355,3394
801,仁福里,2018,2267,5841,2861,2980
802,重陽里,2018,2396,5781,2757,3024
804,西湖里,2018,2826,7491,3611,3880
805,西康里,2018,3837,9725,4645,5080
806,西安里,2018,2591,6836,3255,3581
807,港墘里,2018,2376,6435,3045,3390
808,港都里,2018,2166,6035,2895,3140
809,港富里,2018,3602,10066,4806,5260
810,港華里,2018,3357,9765,4636,5129
811,內湖里,2018,2611,6168,2836,3332
812,湖濱里,2018,3313,8681,4072,4609
813,紫星里,2018,3048,8316,3994,4322
814,大湖里,2018,2180,5707,2664,3043
815,金龍里,2018,2071,5576,2753,2823
816,金瑞里,2018,2598,7054,3306,3748
817,碧山里,2018,2705,7363,3585,3778
818,紫雲里,2018,2295,6178,2965,3213
819,清白里,2018,3718,8880,4112,4768
820,葫洲里,2018,2744,7935,3780,4155
821,紫陽里,2018,3196,8458,4063,4395
822,瑞陽里,2018,3160,8046,3804,4242
823,瑞光里,2018,1781,4806,2242,2564
824,五分里,2018,4153,11939,5691,6248
825,東湖里,2018,2843,8126,3928,4198
826,樂康里,2018,3172,9182,4405,4777
827,內溝里,2018,1834,5026,2454,2572
828,週美里,2018,3572,8340,4020,4320
829,行善里,2018,2826,7053,3482,3571
830,石潭里,2018,1977,4145,1965,2180
831,湖興里,2018,4079,8942,4447,4495
832,湖元里,2018,2106,5703,2743,2960
833,安湖里,2018,2733,8333,3981,4352
834,秀湖里,2018,2461,6500,3136,3364
835,安泰里,2018,2112,5832,2792,3040
836,金湖里,2018,3942,10617,4935,5682
837,康寧里,2018,3168,9553,4585,4968
838,明湖里,2018,2002,6025,2864,3161
839,蘆洲里,2018,510,1422,767,655
840,麗山里,2018,2321,6386,3037,3349
841,寶湖里,2018,3810,9055,4358,4697
842,南湖里,2018,2223,6142,2861,3281
844,仁勇里,2018,1546,4175,2021,2154
845,義信里,2018,1378,3419,1652,1767
846,福林里,2018,1258,3151,1525,1626
847,福德里,2018,2978,6126,3219,2907
848,福志里,2018,3053,7899,3737,4162
849,舊佳里,2018,2533,6469,3046,3423
850,福佳里,2018,3007,8185,3925,4260
851,後港里,2018,3090,8612,4271,4341
852,福中里,2018,2608,7363,3546,3817
853,前港里,2018,1767,4894,2337,2557
854,百齡里,2018,2555,7593,3707,3886
855,承德里,2018,2363,5801,2720,3081
856,福華里,2018,2583,6650,3199,3451
857,明勝里,2018,1991,5200,2494,2706
858,福順里,2018,2117,5551,2751,2800
859,富光里,2018,2175,6225,3055,3170
860,葫蘆里,2018,2850,8090,3897,4193
861,葫東里,2018,1598,4314,2104,2210
862,社子里,2018,2478,6879,3369,3510
863,社新里,2018,3474,9663,4818,4845
864,社園里,2018,2643,7742,3876,3866
865,永倫里,2018,2758,7573,3789,3784
866,福安里,2018,1841,5006,2668,2338
867,富洲里,2018,2421,6115,3216,2899
868,岩山里,2018,1271,3534,1678,1856
869,名山里,2018,2686,7440,3419,4021
870,德行里,2018,1934,4591,2136,2455
871,德華里,2018,2252,5844,2720,3124
872,聖山里,2018,1960,5347,2522,2825
873,忠誠里,2018,2195,5832,2787,3045
874,芝山里,2018,2774,7937,3794,4143
875,東山里,2018,1820,5371,2603,2768
876,三玉里,2018,2170,6066,2855,3211
877,蘭雅里,2018,3335,9144,4298,4846
878,蘭興里,2018,2476,6758,3172,3586
879,天福里,2018,2349,6664,3116,3548
880,天祿里,2018,1992,5513,2550,2963
881,天壽里,2018,1968,5329,2458,2871
882,天和里,2018,2786,8053,3836,4217
883,天山里,2018,2702,7302,3415,3887
884,天玉里,2018,3515,9401,4345,5056
885,天母里,2018,2591,7093,3344,3749
886,永福里,2018,463,1307,636,671
887,公館里,2018,542,1433,746,687
888,新安里,2018,750,1994,991,1003
889,陽明里,2018,1396,3108,1490,1618
890,菁山里,2018,587,1670,907,763
891,平等里,2018,535,1538,780,758
892,溪山里,2018,565,1539,789,750
893,翠山里,2018,1196,2774,1319,1455
894,臨溪里,2018,1205,3063,1491,1572
896,建民里,2018,1708,4379,2102,2277
897,文林里,2018,1711,4406,2122,2284
898,石牌里,2018,2085,5525,2617,2908
899,福興里,2018,2733,7604,3600,4004
900,榮光里,2018,2818,8098,3847,4251
901,榮華里,2018,2954,7752,3634,4118
902,裕民里,2018,3100,8088,3846,4242
903,振華里,2018,2912,8081,3811,4270
904,永和里,2018,3721,9595,4562,5033
905,永欣里,2018,3479,8337,3877,4460
906,永明里,2018,1891,5306,2491,2815
907,東華里,2018,1642,4734,2211,2523
908,吉利里,2018,2611,7607,3645,3962
909,吉慶里,2018,1964,5749,2714,3035
910,尊賢里,2018,1778,5124,2409,2715
911,立賢里,2018,2060,5914,2832,3082
912,立農里,2018,3408,9656,4633,5023
913,八仙里,2018,2212,5829,2842,2987
914,洲美里,2018,829,2180,1095,1085
915,奇岩里,2018,3904,10316,5051,5265
916,清江里,2018,4258,9746,4962,4784
917,中央里,2018,3403,8966,4282,4684
918,長安里,2018,2673,6479,2990,3489
919,大同里,2018,2375,6178,3029,3149
920,溫泉里,2018,2801,6956,3288,3668
921,林泉里,2018,1457,3189,1548,1641
922,中心里,2018,3095,6670,3095,3575
923,中庸里,2018,1724,4416,2145,2271
924,開明里,2018,2627,6849,3281,3568
925,中和里,2018,1954,5161,2488,2673
926,智仁里,2018,2322,6513,3122,3391
927,秀山里,2018,1227,3425,1676,1749
928,文化里,2018,1670,4532,2183,2349
929,豐年里,2018,1697,4851,2378,2473
930,稻香里,2018,2210,5666,2818,2848
931,桃源里,2018,2348,6318,3082,3236
932,一德里,2018,2837,7838,3851,3987
933,關渡里,2018,4229,11900,5891,6009
934,泉源里,2018,858,2441,1286,1155
935,湖山里,2018,703,1734,895,839
936,大屯里,2018,423,1255,657,598
937,湖田里,2018,382,996,545,451
940,莊敬里,2019,2067,5472,2640,2832
941,東榮里,2019,3058,8335,3867,4468
942,三民里,2019,2924,7053,3259,3794
943,新益里,2019,1848,4667,2240,2427
944,富錦里,2019,2131,5335,2442,2893
945,新東里,2019,2022,5107,2408,2699
946,富泰里,2019,2036,4801,2077,2724
947,介壽里,2019,1771,4752,2240,2512
948,精忠里,2019,1775,4640,2151,2489
949,東光里,2019,3043,7229,3388,3841
950,龍田里,2019,4334,11211,5239,5972
951,東昌里,2019,1060,2929,1361,1568
952,東勢里,2019,1826,4525,2109,2416
953,中華里,2019,2560,6716,3121,3595
954,民有里,2019,3506,8967,4149,4818
955,民福里,2019,2676,6457,3062,3395
956,慈祐里,2019,4057,8076,3991,4085
957,安平里,2019,3678,8626,4129,4497
958,鵬程里,2019,2184,5547,2665,2882
959,自強里,2019,3905,10199,4800,5399
960,吉祥里,2019,3434,8611,3998,4613
961,新聚里,2019,3364,8237,3813,4424
962,復盛里,2019,2559,6503,3064,3439
963,中正里,2019,3924,10569,4936,5633
964,中崙里,2019,1701,4427,2054,2373
965,美仁里,2019,1373,3778,1794,1984
966,吉仁里,2019,1579,4222,1982,2240
967,敦化里,2019,2573,7338,3455,3883
968,復源里,2019,1251,3416,1629,1787
969,復建里,2019,1829,4772,2263,2509
970,復勢里,2019,2614,6622,3028,3594
971,福成里,2019,1008,2767,1288,1479
972,松基里,2019,1485,3727,1715,2012
974,西村里,2019,2901,5891,3017,2874
975,正和里,2019,1932,4765,2178,2587
976,興隆里,2019,1226,2900,1357,1543
977,中興里,2019,1754,3588,1579,2009
978,新仁里,2019,1382,3468,1626,1842
979,興雅里,2019,2470,5879,2744,3135
980,敦厚里,2019,2298,5339,2471,2868
981,廣居里,2019,3155,8284,3864,4420
982,安康里,2019,4438,11142,5261,5881
983,六藝里,2019,1404,3878,1884,1994
984,雅祥里,2019,2100,5105,2498,2607
985,五常里,2019,1462,3769,1826,1943
986,五全里,2019,2008,5038,2384,2654
987,永吉里,2019,1444,4128,2083,2045
988,長春里,2019,1726,4368,2122,2246
989,四育里,2019,2224,5727,2829,2898
990,四維里,2019,2158,5429,2590,2839
991,永春里,2019,1997,5055,2446,2609
992,富台里,2019,1969,4557,2120,2437
993,國業里,2019,3043,8138,3864,4274
994,松隆里,2019,878,2286,1120,1166
995,松友里,2019,2572,7133,3363,3770
996,松光里,2019,2089,5012,2415,2597
997,中坡里,2019,1687,4515,2200,2315
998,中行里,2019,2979,8208,4013,4195
999,大道里,2019,2437,6225,3019,3206
1000,大仁里,2019,1636,4103,1960,2143
1001,景新里,2019,2169,5289,2460,2829
1002,惠安里,2019,2641,6730,3262,3468
1003,三張里,2019,3675,9109,4360,4749
1004,三犁里,2019,2160,5336,2509,2827
1005,六合里,2019,2814,6904,3271,3633
1006,泰和里,2019,3140,8070,3817,4253
1007,景聯里,2019,1922,4675,2188,2487
1008,景勤里,2019,1691,4132,1992,2140
1009,雙和里,2019,2953,7365,3485,3880
1010,嘉興里,2019,1308,3217,1477,1740
1011,黎順里,2019,1772,4164,1994,2170
1012,黎平里,2019,3006,7191,3372,3819
1013,黎忠里,2019,2007,4904,2297,2607
1014,黎安里,2019,926,2097,1013,1084
1016,德安里,2019,2361,5922,2730,3192
1017,仁慈里,2019,2040,5824,2739,3085
1018,和安里,2019,2555,7429,3617,3812
1019,民炤里,2019,3293,8424,3922,4502
1020,仁愛里,2019,2199,5431,2419,3012
1021,義村里,2019,2449,5694,2672,3022
1022,民輝里,2019,2882,6925,3271,3654
1023,昌隆里,2019,1254,3149,1491,1658
1024,誠安里,2019,1813,4162,1867,2295
1025,光武里,2019,3293,7719,3491,4228
1026,龍坡里,2019,2338,6144,2845,3299
1027,龍泉里,2019,2080,5208,2395,2813
1028,古風里,2019,1790,4316,2036,2280
1029,古莊里,2019,3172,7505,3452,4053
1030,龍安里,2019,3759,8427,4161,4266
1031,錦安里,2019,2369,6447,2983,3464
1032,福住里,2019,2415,6905,3160,3745
1033,永康里,2019,1518,4053,1926,2127
1034,光明里,2019,1441,3997,1940,2057
1035,錦泰里,2019,1403,3952,1904,2048
1036,錦華里,2019,2194,6225,2931,3294
1037,龍圖里,2019,2881,7036,3262,3774
1038,新龍里,2019,2650,7167,3351,3816
1039,龍陣里,2019,1444,3532,1655,1877
1040,龍雲里,2019,1892,4944,2270,2674
1041,龍生里,2019,2623,7152,3343,3809
1042,住安里,2019,2317,5314,2495,2819
1043,義安里,2019,2207,5448,2472,2976
1044,通化里,2019,2648,6343,3001,3342
1045,通安里,2019,2316,5607,2671,2936
1046,臨江里,2019,1749,4216,1983,2233
1047,法治里,2019,1889,4597,2143,2454
1048,全安里,2019,1833,4485,2068,2417
1049,群賢里,2019,2482,5995,2712,3283
1050,群英里,2019,2968,7047,3268,3779
1051,虎嘯里,2019,1727,3920,1792,2128
1052,臥龍里,2019,874,2339,1058,1281
1053,龍淵里,2019,3587,10373,4916,5457
1054,龍門里,2019,1670,4664,2161,2503
1055,大學里,2019,3572,8848,4113,4735
1056,芳和里,2019,2339,5869,2836,3033
1057,黎元里,2019,2096,5722,2733,2989
1058,黎孝里,2019,3050,7809,3732,4077
1059,黎和里,2019,2052,4934,2329,2605
1060,建安里,2019,2135,5152,2272,2880
1061,建倫里,2019,2455,6448,2880,3568
1062,敦安里,2019,2498,6629,3012,3617
1063,正聲里,2019,1950,4945,2304,2641
1064,敦煌里,2019,2409,6589,3031,3558
1065,華聲里,2019,1750,4363,2022,2341
1066,車層里,2019,2512,6538,2976,3562
1067,光信里,2019,3076,8028,3718,4310
1068,學府里,2019,1064,2775,1374,1401
1070,正守里,2019,1422,3323,1587,1736
1071,正義里,2019,2810,5354,2321,3033
1072,正得里,2019,2003,3715,1641,2074
1073,民安里,2019,2131,4631,2187,2444
1074,康樂里,2019,1540,2632,1100,1532
1075,中山里,2019,3800,6850,2937,3913
1076,聚盛里,2019,2404,4294,1843,2451
1077,集英里,2019,3291,7448,3366,4082
1078,聚葉里,2019,2030,4079,1851,2228
1079,恆安里,2019,2601,5005,2156,2849
1080,晴光里,2019,2958,5603,2457,3146
1081,圓山里,2019,1973,4393,1999,2394
1082,劍潭里,2019,1440,3867,1854,2013
1083,大直里,2019,3596,9714,4606,5108
1084,成功里,2019,2991,7230,3310,3920
1085,永安里,2019,3872,9923,4594,5329
1086,大佳里,2019,411,1109,594,515
1087,新喜里,2019,2179,5513,2590,2923
1088,新庄里,2019,2189,5166,2435,2731
1089,新福里,2019,2251,5321,2459,2862
1090,松江里,2019,2617,6699,3145,3554
1091,新生里,2019,2175,5031,2345,2686
1092,中庄里,2019,2338,5251,2504,2747
1093,行政里,2019,3882,7599,3888,3711
1094,行仁里,2019,3074,8444,4012,4432
1095,行孝里,2019,1636,4235,2029,2206
1096,下埤里,2019,3004,7665,3587,4078
1097,江寧里,2019,2855,7165,3367,3798
1098,江山里,2019,3115,7752,3699,4053
1099,中吉里,2019,2377,5884,2781,3103
1100,中原里,2019,2264,5221,2460,2761
1101,興亞里,2019,2490,5421,2513,2908
1102,中央里,2019,1583,3892,1824,2068
1103,朱馥里,2019,2538,6112,2823,3289
1104,龍洲里,2019,2127,5085,2353,2732
1105,朱園里,2019,2241,4668,2130,2538
1106,埤頭里,2019,1553,3392,1648,1744
1107,朱崙里,2019,1338,2873,1295,1578
1108,力行里,2019,2725,6191,2883,3308
1109,復華里,2019,2190,4835,2220,2615
1110,金泰里,2019,3457,8003,3871,4132
1111,北安里,2019,1014,2721,1298,1423
1113,水源里,2019,1386,3045,1420,1625
1114,富水里,2019,1076,2689,1315,1374
1115,文盛里,2019,1123,2499,1208,1291
1116,林興里,2019,2102,4798,2282,2516
1117,河堤里,2019,2004,4630,2207,2423
1118,頂東里,2019,2823,6133,2840,3293
1119,網溪里,2019,2521,5957,2764,3193
1120,板溪里,2019,1508,3346,1575,1771
1121,螢圃里,2019,2475,5628,2690,2938
1122,螢雪里,2019,1822,4446,2137,2309
1123,永功里,2019,2553,6479,3140,3339
1124,永昌里,2019,2073,5058,2487,2571
1125,龍興里,2019,1594,4326,2098,2228
1126,忠勤里,2019,3027,6558,3093,3465
1127,廈安里,2019,1874,4988,2416,2572
1128,愛國里,2019,1363,3483,1578,1905
1129,南門里,2019,1063,2900,1355,1545
1130,龍光里,2019,1334,3677,1802,1875
1131,南福里,2019,4576,11496,5554,5942
1132,龍福里,2019,2412,6175,2969,3206
1133,新營里,2019,3622,10140,4923,5217
1134,建國里,2019,735,1824,828,996
1135,光復里,2019,1849,3971,1856,2115
1136,黎明里,2019,1657,3489,1699,1790
1137,梅花里,2019,1408,3214,1515,1699
1138,幸福里,2019,2850,5865,2997,2868
1139,幸市里,2019,1925,4542,2141,2401
1140,東門里,2019,1675,4128,1965,2163
1141,文北里,2019,2317,5807,2768,3039
1142,文祥里,2019,3150,8567,4048,4519
1143,三愛里,2019,3567,9045,4170,4875
1145,玉泉里,2019,1267,3044,1504,1540
1146,建明里,2019,1554,3505,1666,1839
1147,建功里,2019,2073,4888,2329,2559
1148,建泰里,2019,1653,3970,1908,2062
1149,永樂里,2019,2261,5527,2754,2773
1150,朝陽里,2019,1988,4484,2138,2346
1151,星明里,2019,2639,6405,3036,3369
1152,光能里,2019,2030,5344,2579,2765
1153,大有里,2019,1915,5033,2464,2569
1154,延平里,2019,1860,4297,2059,2238
1155,雙連里,2019,3767,9901,4785,5116
1156,南芳里,2019,1704,4302,2008,2294
1157,民權里,2019,2590,6852,3293,3559
1158,景星里,2019,1161,2769,1381,1388
1159,隆和里,2019,1246,3278,1581,1697
1160,蓬萊里,2019,2134,5163,2496,2667
1161,國順里,2019,1086,2783,1454,1329
1162,國慶里,2019,1860,4591,2169,2422
1163,揚雅里,2019,2332,4506,2424,2082
1164,斯文里,2019,2144,5069,2506,2563
1165,鄰江里,2019,2647,6629,3324,3305
1166,至聖里,2019,3392,8244,3958,4286
1167,老師里,2019,2346,6081,3016,3065
1168,重慶里,2019,2531,6775,3233,3542
1169,保安里,2019,1673,4211,2059,2152
1171,福星里,2019,2744,5659,2686,2973
1172,萬壽里,2019,1862,3397,1650,1747
1173,西門里,2019,2001,3843,1773,2070
1174,新起里,2019,3071,6702,3140,3562
1175,菜園里,2019,2758,6335,3175,3160
1176,青山里,2019,2675,5864,2856,3008
1177,富民里,2019,2209,4999,2449,2550
1178,福音里,2019,1820,4071,1973,2098
1179,仁德里,2019,2151,4871,2334,2537
1180,富福里,2019,3182,6144,3422,2722
1181,頂碩里,2019,2960,7381,3704,3677
1182,雙園里,2019,1897,4819,2375,2444
1183,新忠里,2019,1573,3513,1663,1850
1184,新和里,2019,3446,8620,4122,4498
1185,糖?里,2019,2235,5635,2799,2836
1186,和平里,2019,2826,7085,3497,3588
1187,綠堤里,2019,1743,4440,2173,2267
1188,華江里,2019,3290,8849,4311,4538
1189,柳鄉里,2019,2126,5390,2675,2715
1190,日善里,2019,1417,3853,1907,1946
1191,新安里,2019,2643,6276,3100,3176
1192,忠德里,2019,1783,4635,2299,2336
1193,孝德里,2019,1248,3341,1662,1679
1194,和德里,2019,2728,7150,3548,3602
1195,錦德里,2019,2169,5671,2752,2919
1196,全德里,2019,1736,4551,2289,2262
1197,保德里,2019,1291,3428,1682,1746
1198,銘德里,2019,1862,4886,2382,2504
1199,榮德里,2019,1387,3756,1880,1876
1200,壽德里,2019,1969,5376,2637,2739
1201,興德里,2019,1776,4919,2425,2494
1202,華中里,2019,2443,6421,3108,3313
1203,日祥里,2019,2463,5690,2765,2925
1204,忠貞里,2019,2292,4914,2326,2588
1205,凌霄里,2019,1653,3767,1777,1990
1206,騰雲里,2019,1339,3136,1509,1627
1208,景行里,2019,3344,8105,3800,4305
1209,景東里,2019,2982,7731,3614,4117
1210,景美里,2019,2081,5452,2552,2900
1211,景慶里,2019,2561,6909,3270,3639
1212,景仁里,2019,2200,5528,2619,2909
1213,景華里,2019,2292,6150,2884,3266
1214,萬有里,2019,2223,5903,2846,3057
1215,萬祥里,2019,1878,4700,2234,2466
1216,萬隆里,2019,2883,7571,3544,4027
1217,萬年里,2019,2275,5516,2659,2857
1218,萬和里,2019,1426,3382,1607,1775
1219,萬盛里,2019,2064,4826,2322,2504
1220,興豐里,2019,2074,5045,2415,2630
1221,興光里,2019,1475,3481,1594,1887
1222,興家里,2019,2950,7822,3811,4011
1223,興得里,2019,2408,6061,2908,3153
1224,興業里,2019,2163,5644,2665,2979
1225,興安里,2019,2752,6998,3309,3689
1226,興福里,2019,2168,6065,2907,3158
1227,興旺里,2019,3478,8679,4160,4519
1228,興泰里,2019,1703,4061,1956,2105
1229,興昌里,2019,2827,6954,3290,3664
1230,試院里,2019,2830,7170,3432,3738
1231,華興里,2019,3642,9411,4539,4872
1232,明義里,2019,1751,4597,2205,2392
1233,明興里,2019,2799,7049,3369,3680
1234,木柵里,2019,3603,9174,4315,4859
1235,木新里,2019,4560,10462,5280,5182
1236,順興里,2019,2923,7897,3828,4069
1237,樟林里,2019,3241,8757,4293,4464
1238,樟新里,2019,2199,5884,2790,3094
1239,樟腳里,2019,2130,5967,2878,3089
1240,萬芳里,2019,3158,8199,3855,4344
1241,博嘉里,2019,2275,6123,2938,3185
1242,萬興里,2019,3289,8828,4279,4549
1243,指南里,2019,1744,4128,2120,2008
1244,老泉里,2019,368,966,499,467
1245,忠順里,2019,1734,4150,1970,2180
1246,萬美里,2019,2927,7625,3678,3947
1247,政大里,2019,2974,8091,3903,4188
1248,樟文里,2019,2317,6362,3114,3248
1249,興邦里,2019,2169,5115,2430,2685
1250,樟樹里,2019,1872,5148,2433,2715
1252,南港里,2019,2895,6808,3486,3322
1253,中南里,2019,1509,3949,1962,1987
1254,新富里,2019,1579,4189,2074,2115
1255,三重里,2019,3568,7837,3809,4028
1256,東新里,2019,2804,7616,3742,3874
1257,新光里,2019,1528,3858,1835,2023
1258,東明里,2019,1937,4902,2397,2505
1259,西新里,2019,1857,5029,2468,2561
1260,玉成里,2019,2012,5022,2436,2586
1261,合成里,2019,2774,6947,3355,3592
1262,成福里,2019,2961,7912,3798,4114
1263,萬福里,2019,1738,4410,2117,2293
1264,鴻福里,2019,1735,4663,2224,2439
1265,百福里,2019,2158,5603,2731,2872
1266,聯成里,2019,2023,5288,2593,2695
1267,舊莊里,2019,3527,9404,4598,4806
1268,中研里,2019,3594,9885,4852,5033
1269,九如里,2019,2502,6701,3301,3400
1270,仁福里,2019,2266,5806,2857,2949
1271,重陽里,2019,2424,5747,2757,2990
1273,西湖里,2019,2838,7445,3597,3848
1274,西康里,2019,3859,9774,4650,5124
1275,西安里,2019,2587,6810,3227,3583
1276,港墘里,2019,2381,6401,2998,3403
1277,港都里,2019,2154,5925,2849,3076
1278,港富里,2019,3627,10037,4803,5234
1279,港華里,2019,3389,9804,4679,5125
1280,內湖里,2019,2715,6263,2864,3399
1281,湖濱里,2019,3354,8721,4086,4635
1282,紫星里,2019,3058,8307,3998,4309
1283,大湖里,2019,2189,5742,2675,3067
1284,金龍里,2019,2059,5524,2713,2811
1285,金瑞里,2019,2605,7036,3292,3744
1286,碧山里,2019,2754,7368,3567,3801
1287,紫雲里,2019,2300,6092,2934,3158
1288,清白里,2019,3748,8859,4105,4754
1289,葫洲里,2019,2774,7927,3766,4161
1290,紫陽里,2019,3188,8335,3997,4338
1291,瑞陽里,2019,3173,7999,3794,4205
1292,瑞光里,2019,1791,4780,2231,2549
1293,五分里,2019,4142,11830,5613,6217
1294,東湖里,2019,2854,8004,3867,4137
1295,樂康里,2019,3151,9056,4348,4708
1296,內溝里,2019,1825,4906,2389,2517
1297,週美里,2019,3656,8667,4177,4490
1298,行善里,2019,2853,7120,3506,3614
1299,石潭里,2019,2010,4203,1978,2225
1300,湖興里,2019,4081,8794,4382,4412
1301,湖元里,2019,2122,5694,2741,2953
1302,安湖里,2019,2756,8348,3991,4357
1303,秀湖里,2019,2460,6453,3110,3343
1304,安泰里,2019,2115,5786,2775,3011
1305,金湖里,2019,3951,10584,4942,5642
1306,康寧里,2019,3210,9639,4622,5017
1307,明湖里,2019,2023,6030,2859,3171
1308,蘆洲里,2019,515,1423,763,660
1309,麗山里,2019,2346,6374,3022,3352
1310,寶湖里,2019,3891,9268,4456,4812
1311,南湖里,2019,2228,6114,2830,3284
1313,仁勇里,2019,1552,4059,1956,2103
1314,義信里,2019,1391,3416,1641,1775
1315,福林里,2019,1261,3111,1499,1612
1316,福德里,2019,2964,6044,3162,2882
1317,福志里,2019,3052,7820,3709,4111
1318,舊佳里,2019,2527,6452,3035,3417
1319,福佳里,2019,3009,8115,3895,4220
1320,後港里,2019,3106,8520,4245,4275
1321,福中里,2019,2632,7316,3546,3770
1322,前港里,2019,1757,4786,2282,2504
1323,百齡里,2019,2556,7494,3643,3851
1324,承德里,2019,2352,5763,2709,3054
1325,福華里,2019,2607,6604,3183,3421
1326,明勝里,2019,1978,5102,2433,2669
1327,福順里,2019,2150,5628,2776,2852
1328,富光里,2019,2192,6184,3031,3153
1329,葫蘆里,2019,2865,8012,3859,4153
1330,葫東里,2019,1603,4301,2090,2211
1331,社子里,2019,2487,6810,3336,3474
1332,社新里,2019,3506,9599,4791,4808
1333,社園里,2019,2662,7692,3842,3850
1334,永倫里,2019,2742,7413,3720,3693
1335,福安里,2019,1863,4974,2635,2339
1336,富洲里,2019,2423,6048,3163,2885
1337,岩山里,2019,1274,3508,1661,1847
1338,名山里,2019,2688,7426,3429,3997
1339,德行里,2019,1943,4576,2151,2425
1340,德華里,2019,2282,5867,2737,3130
1341,聖山里,2019,1957,5272,2474,2798
1342,忠誠里,2019,2214,5788,2743,3045
1343,芝山里,2019,2779,7889,3759,4130
1344,東山里,2019,1828,5366,2574,2792
1345,三玉里,2019,2195,6060,2839,3221
1346,蘭雅里,2019,3339,9061,4251,4810
1347,蘭興里,2019,2483,6706,3119,3587
1348,天福里,2019,2384,6692,3123,3569
1349,天祿里,2019,1993,5477,2554,2923
1350,天壽里,2019,2009,5369,2457,2912
1351,天和里,2019,2793,7991,3797,4194
1352,天山里,2019,2713,7279,3415,3864
1353,天玉里,2019,3518,9341,4302,5039
1354,天母里,2019,2589,7032,3315,3717
1355,永福里,2019,456,1292,632,660
1356,公館里,2019,537,1426,739,687
1357,新安里,2019,748,1971,978,993
1358,陽明里,2019,1446,3115,1498,1617
1359,菁山里,2019,588,1654,893,761
1360,平等里,2019,541,1553,788,765
1361,溪山里,2019,582,1566,802,764
1362,翠山里,2019,1195,2747,1280,1467
1363,臨溪里,2019,1204,3052,1474,1578
1365,建民里,2019,1792,4416,2119,2297
1366,文林里,2019,1729,4392,2112,2280
1367,石牌里,2019,2088,5446,2594,2852
1368,福興里,2019,2734,7564,3579,3985
1369,榮光里,2019,2836,8108,3845,4263
1370,榮華里,2019,2958,7699,3609,4090
1371,裕民里,2019,3140,8035,3798,4237
1372,振華里,2019,2922,7994,3763,4231
1373,永和里,2019,3719,9533,4516,5017
1374,永欣里,2019,3515,8449,3923,4526
1375,永明里,2019,1899,5335,2508,2827
1376,東華里,2019,1649,4711,2223,2488
1377,吉利里,2019,2637,7625,3623,4002
1378,吉慶里,2019,1942,5605,2668,2937
1379,尊賢里,2019,1791,5111,2411,2700
1380,立賢里,2019,2076,5894,2823,3071
1381,立農里,2019,3429,9719,4669,5050
1382,八仙里,2019,2210,5751,2793,2958
1383,洲美里,2019,770,2048,1032,1016
1384,奇岩里,2019,4088,10529,5118,5411
1385,清江里,2019,4252,9629,4902,4727
1386,中央里,2019,3422,8896,4284,4612
1387,長安里,2019,2749,6533,3012,3521
1388,大同里,2019,2374,6043,2955,3088
1389,溫泉里,2019,2803,6859,3253,3606
1390,林泉里,2019,1450,3159,1548,1611
1391,中心里,2019,3104,6659,3061,3598
1392,中庸里,2019,1752,4414,2146,2268
1393,開明里,2019,2645,6806,3252,3554
1394,中和里,2019,1953,5108,2465,2643
1395,智仁里,2019,2329,6405,3058,3347
1396,秀山里,2019,1231,3392,1651,1741
1397,文化里,2019,1667,4476,2172,2304
1398,豐年里,2019,1691,4785,2332,2453
1399,稻香里,2019,2213,5676,2819,2857
1400,桃源里,2019,2352,6283,3075,3208
1401,一德里,2019,2840,7847,3829,4018
1402,關渡里,2019,4238,11860,5875,5985
1403,泉源里,2019,866,2472,1296,1176
1404,湖山里,2019,703,1672,865,807
1405,大屯里,2019,427,1259,665,594
1406,湖田里,2019,382,986,534,452
1409,莊敬里,2020,2061,5449,2631,2818
1410,東榮里,2020,3079,8243,3842,4401
1411,三民里,2020,2900,6969,3199,3770
1412,新益里,2020,1846,4667,2224,2443
1413,富錦里,2020,2139,5315,2426,2889
1414,新東里,2020,2036,5100,2417,2683
1415,富泰里,2020,2041,4719,2035,2684
1416,介壽里,2020,1768,4727,2221,2506
1417,精忠里,2020,1774,4637,2164,2473
1418,東光里,2020,3023,7120,3341,3779
1419,龍田里,2020,4365,11269,5238,6031
1420,東昌里,2020,1049,2857,1324,1533
1421,東勢里,2020,1840,4488,2101,2387
1422,中華里,2020,2582,6833,3152,3681
1423,民有里,2020,3505,8888,4090,4798
1424,民福里,2020,2645,6359,3008,3351
1425,慈祐里,2020,4146,8138,3995,4143
1426,安平里,2020,3682,8488,4049,4439
1427,鵬程里,2020,2186,5480,2629,2851
1428,自強里,2020,3861,10014,4701,5313
1429,吉祥里,2020,3422,8384,3876,4508
1430,新聚里,2020,3336,8058,3713,4345
1431,復盛里,2020,2562,6397,3002,3395
1432,中正里,2020,3950,10497,4865,5632
1433,中崙里,2020,1714,4455,2080,2375
1434,美仁里,2020,1385,3772,1790,1982
1435,吉仁里,2020,1580,4232,1977,2255
1436,敦化里,2020,2598,7320,3452,3868
1437,復源里,2020,1266,3463,1652,1811
1438,復建里,2020,1833,4775,2265,2510
1439,復勢里,2020,2623,6538,3002,3536
1440,福成里,2020,1006,2709,1255,1454
1441,松基里,2020,1486,3683,1690,1993
1443,西村里,2020,2910,5822,2963,2859
1444,正和里,2020,1941,4756,2177,2579
1445,興隆里,2020,1181,2746,1276,1470
1446,中興里,2020,1753,3541,1552,1989
1447,新仁里,2020,1371,3403,1602,1801
1448,興雅里,2020,2465,5767,2697,3070
1449,敦厚里,2020,2298,5270,2436,2834
1450,廣居里,2020,3143,8125,3811,4314
1451,安康里,2020,4401,11015,5181,5834
1452,六藝里,2020,1395,3835,1848,1987
1453,雅祥里,2020,2128,5142,2512,2630
1454,五常里,2020,1463,3684,1774,1910
1455,五全里,2020,1958,4861,2281,2580
1456,永吉里,2020,1447,4066,2031,2035
1457,長春里,2020,1723,4310,2097,2213
1458,四育里,2020,2188,5559,2731,2828
1459,四維里,2020,2147,5309,2538,2771
1460,永春里,2020,2029,5033,2417,2616
1461,富台里,2020,1971,4511,2079,2432
1462,國業里,2020,3024,7982,3807,4175
1463,松隆里,2020,875,2220,1085,1135
1464,松友里,2020,2556,7102,3348,3754
1465,松光里,2020,2085,4927,2370,2557
1466,中坡里,2020,1699,4471,2173,2298
1467,中行里,2020,2945,8027,3922,4105
1468,大道里,2020,2443,6134,2964,3170
1469,大仁里,2020,1642,4072,1928,2144
1470,景新里,2020,2176,5281,2440,2841
1471,惠安里,2020,2639,6640,3186,3454
1472,三張里,2020,3669,8987,4288,4699
1473,三犁里,2020,2172,5358,2525,2833
1474,六合里,2020,2807,6803,3214,3589
1475,泰和里,2020,3175,7975,3772,4203
1476,景聯里,2020,1924,4642,2162,2480
1477,景勤里,2020,1668,4006,1927,2079
1478,雙和里,2020,2949,7187,3402,3785
1479,嘉興里,2020,1312,3155,1456,1699
1480,黎順里,2020,1774,4088,1934,2154
1481,黎平里,2020,3003,7057,3294,3763
1482,黎忠里,2020,1997,4821,2263,2558
1483,黎安里,2020,905,2054,978,1076
1485,德安里,2020,2371,5915,2740,3175
1486,仁慈里,2020,2057,5853,2757,3096
1487,和安里,2020,2538,7287,3519,3768
1488,民炤里,2020,3318,8448,3935,4513
1489,仁愛里,2020,2176,5385,2416,2969
1490,義村里,2020,2412,5568,2595,2973
1491,民輝里,2020,2876,6825,3223,3602
1492,昌隆里,2020,1274,3137,1457,1680
1493,誠安里,2020,1797,4101,1857,2244
1494,光武里,2020,3269,7588,3423,4165
1495,龍坡里,2020,2354,6125,2854,3271
1496,龍泉里,2020,2163,5355,2474,2881
1497,古風里,2020,1816,4341,2036,2305
1498,古莊里,2020,3260,7661,3507,4154
1499,龍安里,2020,3794,8447,4182,4265
1500,錦安里,2020,2402,6523,3019,3504
1501,福住里,2020,2449,6930,3173,3757
1502,永康里,2020,1517,4019,1908,2111
1503,光明里,2020,1459,4070,1961,2109
1504,錦泰里,2020,1423,4033,1938,2095
1505,錦華里,2020,2222,6291,2973,3318
1506,龍圖里,2020,2844,6954,3211,3743
1507,新龍里,2020,2666,7205,3367,3838
1508,龍陣里,2020,1453,3499,1640,1859
1509,龍雲里,2020,1909,4888,2239,2649
1510,龍生里,2020,2635,7150,3358,3792
1511,住安里,2020,2301,5232,2449,2783
1512,義安里,2020,2204,5411,2432,2979
1513,通化里,2020,2631,6318,2975,3343
1514,通安里,2020,2307,5516,2635,2881
1515,臨江里,2020,1772,4188,1961,2227
1516,法治里,2020,1879,4528,2104,2424
1517,全安里,2020,1839,4449,2039,2410
1518,群賢里,2020,2469,5923,2673,3250
1519,群英里,2020,2963,6954,3197,3757
1520,虎嘯里,2020,1714,3913,1799,2114
1521,臥龍里,2020,892,2396,1106,1290
1522,龍淵里,2020,3584,10344,4895,5449
1523,龍門里,2020,1678,4711,2177,2534
1524,大學里,2020,3594,8910,4117,4793
1525,芳和里,2020,2328,5804,2783,3021
1526,黎元里,2020,2095,5623,2682,2941
1527,黎孝里,2020,3062,7793,3710,4083
1528,黎和里,2020,2025,4819,2272,2547
1529,建安里,2020,2122,5049,2216,2833
1530,建倫里,2020,2479,6441,2844,3597
1531,敦安里,2020,2508,6629,3010,3619
1532,正聲里,2020,1942,4904,2279,2625
1533,敦煌里,2020,2396,6520,2986,3534
1534,華聲里,2020,1747,4361,2014,2347
1535,車層里,2020,2519,6508,2924,3584
1536,光信里,2020,3066,7965,3668,4297
1537,學府里,2020,1039,2719,1340,1379
1539,正守里,2020,1434,3312,1585,1727
1540,正義里,2020,2803,5273,2281,2992
1541,正得里,2020,2016,3700,1613,2087
1542,民安里,2020,2116,4562,2164,2398
1543,康樂里,2020,1526,2625,1095,1530
1544,中山里,2020,3835,6827,2933,3894
1545,聚盛里,2020,2404,4230,1840,2390
1546,集英里,2020,3352,7431,3346,4085
1547,聚葉里,2020,2042,4053,1849,2204
1548,恆安里,2020,2636,5019,2169,2850
1549,晴光里,2020,2978,5570,2405,3165
1550,圓山里,2020,1976,4342,1983,2359
1551,劍潭里,2020,1436,3829,1830,1999
1552,大直里,2020,3583,9587,4559,5028
1553,成功里,2020,2920,7079,3232,3847
1554,永安里,2020,3858,9846,4578,5268
1555,大佳里,2020,421,1102,595,507
1556,新喜里,2020,2159,5368,2507,2861
1557,新庄里,2020,2194,5057,2365,2692
1558,新福里,2020,2251,5253,2448,2805
1559,松江里,2020,2576,6582,3071,3511
1560,新生里,2020,2161,4924,2290,2634
1561,中庄里,2020,2306,5160,2463,2697
1562,行政里,2020,3890,7525,3873,3652
1563,行仁里,2020,3050,8285,3938,4347
1564,行孝里,2020,1641,4238,2037,2201
1565,下埤里,2020,3011,7654,3581,4073
1566,江寧里,2020,2869,7106,3338,3768
1567,江山里,2020,3106,7631,3659,3972
1568,中吉里,2020,2377,5883,2769,3114
1569,中原里,2020,2306,5189,2420,2769
1570,興亞里,2020,2516,5409,2501,2908
1571,中央里,2020,1579,3777,1769,2008
1572,朱馥里,2020,2530,6063,2775,3288
1573,龍洲里,2020,2153,5077,2335,2742
1574,朱園里,2020,2272,4646,2121,2525
1575,埤頭里,2020,1540,3320,1599,1721
1576,朱崙里,2020,1434,2950,1337,1613
1577,力行里,2020,2733,6169,2876,3293
1578,復華里,2020,2199,4825,2189,2636
1579,金泰里,2020,3465,8042,3879,4163
1580,北安里,2020,1028,2746,1300,1446
1582,水源里,2020,1399,3097,1426,1671
1583,富水里,2020,1072,2677,1313,1364
1584,文盛里,2020,1160,2589,1257,1332
1585,林興里,2020,2160,4849,2272,2577
1586,河堤里,2020,2005,4557,2164,2393
1587,頂東里,2020,2813,6006,2788,3218
1588,網溪里,2020,2521,5860,2726,3134
1589,板溪里,2020,1500,3235,1508,1727
1590,螢圃里,2020,2502,5651,2704,2947
1591,螢雪里,2020,1831,4412,2110,2302
1592,永功里,2020,2509,6234,3007,3227
1593,永昌里,2020,2061,4973,2438,2535
1594,龍興里,2020,1567,4165,2025,2140
1595,忠勤里,2020,3023,6386,2992,3394
1596,廈安里,2020,1916,4999,2391,2608
1597,愛國里,2020,1375,3494,1571,1923
1598,南門里,2020,1079,2908,1356,1552
1599,龍光里,2020,1329,3639,1785,1854
1600,南福里,2020,4713,11781,5698,6083
1601,龍福里,2020,2354,5995,2864,3131
1602,新營里,2020,3600,9989,4845,5144
1603,建國里,2020,737,1789,816,973
1604,光復里,2020,1869,3937,1867,2070
1605,黎明里,2020,1644,3474,1664,1810
1606,梅花里,2020,1388,3164,1480,1684
1607,幸福里,2020,2841,5787,2926,2861
1608,幸市里,2020,1941,4509,2135,2374
1609,東門里,2020,1669,4087,1975,2112
1610,文北里,2020,2337,5842,2770,3072
1611,文祥里,2020,3199,8594,4055,4539
1612,三愛里,2020,3583,9064,4175,4889
1614,玉泉里,2020,1256,3001,1470,1531
1615,建明里,2020,1520,3367,1610,1757
1616,建功里,2020,2083,4874,2313,2561
1617,建泰里,2020,1634,3878,1872,2006
1618,永樂里,2020,2226,5367,2662,2705
1619,朝陽里,2020,2036,4536,2162,2374
1620,星明里,2020,2636,6349,3021,3328
1621,光能里,2020,2053,5330,2555,2775
1622,大有里,2020,1898,4905,2394,2511
1623,延平里,2020,1896,4270,2058,2212
1624,雙連里,2020,3832,9771,4689,5082
1625,南芳里,2020,1698,4206,1966,2240
1626,民權里,2020,2575,6723,3201,3522
1627,景星里,2020,1161,2739,1361,1378
1628,隆和里,2020,1261,3241,1562,1679
1629,蓬萊里,2020,2114,5060,2425,2635
1630,國順里,2020,1058,2700,1399,1301
1631,國慶里,2020,1909,4669,2196,2473
1632,揚雅里,2020,2397,4538,2473,2065
1633,斯文里,2020,2073,4854,2387,2467
1634,鄰江里,2020,2631,6592,3274,3318
1635,至聖里,2020,3387,8141,3872,4269
1636,老師里,2020,2360,6004,2971,3033
1637,重慶里,2020,2543,6673,3178,3495
1638,保安里,2020,1663,4121,2015,2106
1640,福星里,2020,2767,5570,2638,2932
1641,萬壽里,2020,1839,3322,1609,1713
1642,西門里,2020,2010,3826,1767,2059
1643,新起里,2020,3229,6893,3221,3672
1644,菜園里,2020,2845,6329,3155,3174
1645,青山里,2020,2706,5819,2830,2989
1646,富民里,2020,2224,4975,2435,2540
1647,福音里,2020,1828,3981,1931,2050
1648,仁德里,2020,2160,4803,2303,2500
1649,富福里,2020,3186,6070,3363,2707
1650,頂碩里,2020,2960,7190,3614,3576
1651,雙園里,2020,1889,4720,2340,2380
1652,新忠里,2020,1582,3465,1630,1835
1653,新和里,2020,3461,8535,4077,4458
1654,糖?里,2020,2268,5563,2779,2784
1655,和平里,2020,2814,6922,3431,3491
1656,綠堤里,2020,1747,4408,2139,2269
1657,華江里,2020,3283,8616,4191,4425
1658,柳鄉里,2020,2091,5264,2600,2664
1659,日善里,2020,1414,3838,1892,1946
1660,新安里,2020,2651,6166,3027,3139
1661,忠德里,2020,1802,4581,2272,2309
1662,孝德里,2020,1242,3261,1626,1635
1663,和德里,2020,2664,6799,3384,3415
1664,錦德里,2020,2180,5637,2717,2920
1665,全德里,2020,1756,4477,2247,2230
1666,保德里,2020,1280,3340,1645,1695
1667,銘德里,2020,1844,4752,2319,2433
1668,榮德里,2020,1386,3678,1863,1815
1669,壽德里,2020,1956,5250,2597,2653
1670,興德里,2020,1757,4774,2360,2414
1671,華中里,2020,2435,6269,3049,3220
1672,日祥里,2020,2728,6117,2964,3153
1673,忠貞里,2020,2295,4852,2269,2583
1674,凌霄里,2020,1655,3720,1752,1968
1675,騰雲里,2020,1318,3066,1471,1595
1677,景行里,2020,3342,8095,3818,4277
1678,景東里,2020,2978,7615,3540,4075
1679,景美里,2020,2111,5474,2566,2908
1680,景慶里,2020,2548,6819,3229,3590
1681,景仁里,2020,2344,5782,2718,3064
1682,景華里,2020,2291,6106,2868,3238
1683,萬有里,2020,2231,5856,2842,3014
1684,萬祥里,2020,1893,4748,2249,2499
1685,萬隆里,2020,2929,7550,3542,4008
1686,萬年里,2020,2272,5386,2597,2789
1687,萬和里,2020,1448,3396,1624,1772
1688,萬盛里,2020,2060,4757,2279,2478
1689,興豐里,2020,2083,5042,2424,2618
1690,興光里,2020,1465,3445,1584,1861
1691,興家里,2020,2931,7657,3732,3925
1692,興得里,2020,2415,5976,2855,3121
1693,興業里,2020,2158,5522,2606,2916
1694,興安里,2020,2797,7009,3327,3682
1695,興福里,2020,2161,5950,2837,3113
1696,興旺里,2020,3492,8584,4095,4489
1697,興泰里,2020,1736,4037,1927,2110
1698,興昌里,2020,2832,6843,3236,3607
1699,試院里,2020,2835,7097,3367,3730
1700,華興里,2020,3668,9336,4477,4859
1701,明義里,2020,1881,4743,2253,2490
1702,明興里,2020,2817,6989,3341,3648
1703,木柵里,2020,3632,9086,4274,4812
1704,木新里,2020,4549,10303,5212,5091
1705,順興里,2020,2925,7779,3739,4040
1706,樟林里,2020,3268,8588,4171,4417
1707,樟新里,2020,2192,5817,2759,3058
1708,樟腳里,2020,2137,5890,2837,3053
1709,萬芳里,2020,3150,8102,3811,4291
1710,博嘉里,2020,2298,6127,2928,3199
1711,萬興里,2020,3335,8834,4284,4550
1712,指南里,2020,1751,4136,2101,2035
1713,老泉里,2020,362,940,492,448
1714,忠順里,2020,1728,4126,1959,2167
1715,萬美里,2020,2928,7510,3604,3906
1716,政大里,2020,3000,8140,3931,4209
1717,樟文里,2020,2347,6403,3113,3290
1718,興邦里,2020,2166,5072,2401,2671
1719,樟樹里,2020,1847,5007,2368,2639
1721,南港里,2020,2942,6813,3490,3323
1722,中南里,2020,1501,3851,1913,1938
1723,新富里,2020,1586,4133,2037,2096
1724,三重里,2020,3632,7956,3846,4110
1725,東新里,2020,2827,7597,3758,3839
1726,新光里,2020,1497,3752,1779,1973
1727,東明里,2020,1966,4867,2388,2479
1728,西新里,2020,1862,4915,2373,2542
1729,玉成里,2020,2019,4963,2437,2526
1730,合成里,2020,2773,6817,3307,3510
1731,成福里,2020,2975,7874,3784,4090
1732,萬福里,2020,1744,4351,2080,2271
1733,鴻福里,2020,1735,4562,2178,2384
1734,百福里,2020,2153,5533,2676,2857
1735,聯成里,2020,2023,5191,2538,2653
1736,舊莊里,2020,3530,9211,4481,4730
1737,中研里,2020,3622,9757,4824,4933
1738,九如里,2020,2533,6709,3308,3401
1739,仁福里,2020,2246,5665,2799,2866
1740,重陽里,2020,2409,5644,2707,2937
1742,西湖里,2020,2824,7261,3531,3730
1743,西康里,2020,3887,9677,4576,5101
1744,西安里,2020,2592,6695,3183,3512
1745,港墘里,2020,2400,6379,2989,3390
1746,港都里,2020,2174,5931,2855,3076
1747,港富里,2020,3625,9856,4723,5133
1748,港華里,2020,3449,9872,4685,5187
1749,內湖里,2020,2828,6288,2871,3417
1750,湖濱里,2020,3345,8649,4041,4608
1751,紫星里,2020,3071,8178,3916,4262
1752,大湖里,2020,2193,5658,2644,3014
1753,金龍里,2020,2066,5479,2685,2794
1754,金瑞里,2020,2627,6990,3263,3727
1755,碧山里,2020,2761,7331,3545,3786
1756,紫雲里,2020,2276,5991,2870,3121
1757,清白里,2020,3786,8864,4125,4739
1758,葫洲里,2020,2790,7861,3725,4136
1759,紫陽里,2020,3212,8228,3934,4294
1760,瑞陽里,2020,3169,7835,3695,4140
1761,瑞光里,2020,1792,4681,2194,2487
1762,五分里,2020,4162,11822,5585,6237
1763,東湖里,2020,2829,7841,3785,4056
1764,樂康里,2020,3128,8835,4218,4617
1765,內溝里,2020,1850,4877,2367,2510
1766,週美里,2020,3769,8927,4283,4644
1767,行善里,2020,2972,7241,3535,3706
1768,石潭里,2020,1967,4102,1945,2157
1769,湖興里,2020,4116,8712,4345,4367
1770,湖元里,2020,2122,5597,2711,2886
1771,安湖里,2020,2763,8299,3955,4344
1772,秀湖里,2020,2439,6338,3050,3288
1773,安泰里,2020,2101,5701,2766,2935
1774,金湖里,2020,3953,10500,4861,5639
1775,康寧里,2020,3208,9627,4597,5030
1776,明湖里,2020,2028,5960,2846,3114
1777,蘆洲里,2020,521,1417,761,656
1778,麗山里,2020,2344,6280,2971,3309
1779,寶湖里,2020,4102,9580,4560,5020
1780,南湖里,2020,2254,6166,2866,3300
1782,仁勇里,2020,1575,4026,1941,2085
1783,義信里,2020,1403,3404,1635,1769
1784,福林里,2020,1265,3035,1470,1565
1785,福德里,2020,2973,5977,3113,2864
1786,福志里,2020,3060,7781,3696,4085
1787,舊佳里,2020,2514,6346,3014,3332
1788,福佳里,2020,3021,8037,3857,4180
1789,後港里,2020,3132,8443,4195,4248
1790,福中里,2020,2628,7137,3459,3678
1791,前港里,2020,1738,4689,2244,2445
1792,百齡里,2020,2549,7362,3562,3800
1793,承德里,2020,2353,5709,2680,3029
1794,福華里,2020,2575,6402,3060,3342
1795,明勝里,2020,1981,5014,2398,2616
1796,福順里,2020,2174,5596,2750,2846
1797,富光里,2020,2202,6123,2993,3130
1798,葫蘆里,2020,2855,7900,3786,4114
1799,葫東里,2020,1613,4270,2066,2204
1800,社子里,2020,2481,6700,3311,3389
1801,社新里,2020,3504,9437,4710,4727
1802,社園里,2020,2667,7606,3788,3818
1803,永倫里,2020,2750,7274,3640,3634
1804,福安里,2020,1983,4988,2625,2363
1805,富洲里,2020,2850,6239,3236,3003
1806,岩山里,2020,1256,3481,1663,1818
1807,名山里,2020,2695,7338,3407,3931
1808,德行里,2020,1960,4556,2138,2418
1809,德華里,2020,2270,5810,2690,3120
1810,聖山里,2020,1945,5192,2435,2757
1811,忠誠里,2020,2205,5720,2714,3006
1812,芝山里,2020,2818,7877,3753,4124
1813,東山里,2020,1830,5315,2548,2767
1814,三玉里,2020,2194,5990,2811,3179
1815,蘭雅里,2020,3393,9115,4261,4854
1816,蘭興里,2020,2463,6580,3054,3526
1817,天福里,2020,2397,6666,3117,3549
1818,天祿里,2020,1988,5437,2542,2895
1819,天壽里,2020,1994,5315,2431,2884
1820,天和里,2020,2770,7834,3746,4088
1821,天山里,2020,2718,7239,3381,3858
1822,天玉里,2020,3479,9239,4270,4969
1823,天母里,2020,2575,6932,3279,3653
1824,永福里,2020,455,1280,626,654
1825,公館里,2020,529,1404,728,676
1826,新安里,2020,746,1933,959,974
1827,陽明里,2020,1449,3091,1489,1602
1828,菁山里,2020,590,1618,885,733
1829,平等里,2020,549,1543,779,764
1830,溪山里,2020,578,1547,789,758
1831,翠山里,2020,1194,2734,1280,1454
1832,臨溪里,2020,1209,3001,1451,1550
1834,建民里,2020,1816,4390,2112,2278
1835,文林里,2020,1766,4418,2117,2301
1836,石牌里,2020,2089,5339,2535,2804
1837,福興里,2020,2747,7503,3568,3935
1838,榮光里,2020,2834,8032,3798,4234
1839,榮華里,2020,2971,7629,3570,4059
1840,裕民里,2020,3142,7951,3775,4176
1841,振華里,2020,2924,7853,3694,4159
1842,永和里,2020,3733,9465,4484,4981
1843,永欣里,2020,3556,8467,3883,4584
1844,永明里,2020,1915,5312,2487,2825
1845,東華里,2020,1666,4693,2214,2479
1846,吉利里,2020,2629,7568,3597,3971
1847,吉慶里,2020,1918,5503,2612,2891
1848,尊賢里,2020,1786,5076,2384,2692
1849,立賢里,2020,2093,5926,2818,3108
1850,立農里,2020,3467,9676,4630,5046
1851,八仙里,2020,2221,5700,2766,2934
1852,洲美里,2020,846,2325,1171,1154
1853,奇岩里,2020,4280,10777,5228,5549
1854,清江里,2020,4314,9581,4900,4681
1855,中央里,2020,3393,8660,4178,4482
1856,長安里,2020,2758,6438,2987,3451
1857,大同里,2020,2382,5997,2923,3074
1858,溫泉里,2020,2804,6766,3202,3564
1859,林泉里,2020,1438,3102,1523,1579
1860,中心里,2020,3109,6553,3022,3531
1861,中庸里,2020,1736,4334,2073,2261
1862,開明里,2020,2651,6777,3234,3543
1863,中和里,2020,1972,5065,2437,2628
1864,智仁里,2020,2316,6291,3000,3291
1865,秀山里,2020,1223,3313,1613,1700
1866,文化里,2020,1652,4368,2110,2258
1867,豐年里,2020,1697,4690,2284,2406
1868,稻香里,2020,2226,5545,2740,2805
1869,桃源里,2020,2342,6133,3007,3126
1870,一德里,2020,2892,7813,3798,4015
1871,關渡里,2020,4251,11814,5793,6021
1872,泉源里,2020,863,2427,1262,1165
1873,湖山里,2020,698,1659,863,796
1874,大屯里,2020,437,1275,669,606
1875,湖田里,2020,375,951,519,432
1878,莊敬里,2021,2053,5289,2559,2730
1879,東榮里,2021,3075,8081,3760,4321
1880,三民里,2021,2888,6854,3139,3715
1881,新益里,2021,1848,4605,2190,2415
1882,富錦里,2021,2129,5220,2400,2820
1883,新東里,2021,2036,4995,2368,2627
1884,富泰里,2021,2046,4646,2003,2643
1885,介壽里,2021,1773,4645,2194,2451
1886,精忠里,2021,1784,4600,2149,2451
1887,東光里,2021,2996,6916,3228,3688
1888,龍田里,2021,4321,11124,5168,5956
1889,東昌里,2021,1050,2820,1292,1528
1890,東勢里,2021,1824,4390,2047,2343
1891,中華里,2021,2559,6718,3116,3602
1892,民有里,2021,3483,8674,3960,4714
1893,民福里,2021,2616,6127,2872,3255
1894,慈祐里,2021,4201,8073,3973,4100
1895,安平里,2021,3661,8349,3977,4372
1896,鵬程里,2021,2183,5420,2582,2838
1897,自強里,2021,3687,9350,4361,4989
1898,吉祥里,2021,3398,8160,3771,4389
1899,新聚里,2021,3311,7902,3637,4265
1900,復盛里,2021,2532,6216,2928,3288
1901,中正里,2021,3953,10374,4836,5538
1902,中崙里,2021,1726,4434,2066,2368
1903,美仁里,2021,1384,3734,1766,1968
1904,吉仁里,2021,1570,4152,1956,2196
1905,敦化里,2021,2577,7186,3418,3768
1906,復源里,2021,1266,3411,1607,1804
1907,復建里,2021,1852,4773,2234,2539
1908,復勢里,2021,2606,6430,2943,3487
1909,福成里,2021,1006,2681,1252,1429
1910,松基里,2021,1496,3622,1651,1971
1912,西村里,2021,2933,5791,2938,2853
1913,正和里,2021,1915,4620,2114,2506
1914,興隆里,2021,1162,2644,1222,1422
1915,中興里,2021,1743,3406,1502,1904
1916,新仁里,2021,1370,3333,1577,1756
1917,興雅里,2021,2452,5574,2621,2953
1918,敦厚里,2021,2287,5172,2390,2782
1919,廣居里,2021,3132,7889,3686,4203
1920,安康里,2021,4421,10906,5124,5782
1921,六藝里,2021,1394,3782,1824,1958
1922,雅祥里,2021,2100,5009,2427,2582
1923,五常里,2021,1462,3589,1731,1858
1924,五全里,2021,1946,4715,2204,2511
1925,永吉里,2021,1437,3939,1955,1984
1926,長春里,2021,1704,4184,2039,2145
1927,四育里,2021,2197,5485,2682,2803
1928,四維里,2021,2137,5183,2446,2737
1929,永春里,2021,2027,4905,2362,2543
1930,富台里,2021,1953,4444,2054,2390
1931,國業里,2021,2995,7800,3725,4075
1932,松隆里,2021,871,2216,1086,1130
1933,松友里,2021,2536,6915,3262,3653
1934,松光里,2021,2066,4826,2321,2505
1935,中坡里,2021,1694,4359,2144,2215
1936,中行里,2021,2942,7798,3798,4000
1937,大道里,2021,2426,5974,2887,3087
1938,大仁里,2021,1627,3956,1864,2092
1939,景新里,2021,2157,5187,2371,2816
1940,惠安里,2021,2618,6507,3106,3401
1941,三張里,2021,3672,8838,4235,4603
1942,三犁里,2021,2165,5223,2464,2759
1943,六合里,2021,2794,6654,3154,3500
1944,泰和里,2021,3120,7637,3609,4028
1945,景聯里,2021,1907,4566,2121,2445
1946,景勤里,2021,1631,3874,1866,2008
1947,雙和里,2021,2933,7058,3358,3700
1948,嘉興里,2021,1308,3065,1405,1660
1949,黎順里,2021,1758,3990,1882,2108
1950,黎平里,2021,2989,6943,3217,3726
1951,黎忠里,2021,1984,4744,2230,2514
1952,黎安里,2021,893,1969,919,1050
1954,德安里,2021,2345,5726,2635,3091
1955,仁慈里,2021,2047,5816,2753,3063
1956,和安里,2021,2503,7124,3445,3679
1957,民炤里,2021,3340,8359,3924,4435
1958,仁愛里,2021,2126,5157,2315,2842
1959,義村里,2021,2402,5414,2530,2884
1960,民輝里,2021,2848,6696,3153,3543
1961,昌隆里,2021,1284,3081,1441,1640
1962,誠安里,2021,1786,3962,1764,2198
1963,光武里,2021,3240,7447,3343,4104
1964,龍坡里,2021,2331,6023,2790,3233
1965,龍泉里,2021,2164,5338,2500,2838
1966,古風里,2021,1809,4303,2034,2269
1967,古莊里,2021,3278,7590,3480,4110
1968,龍安里,2021,3852,8446,4192,4254
1969,錦安里,2021,2403,6471,3006,3465
1970,福住里,2021,2442,6816,3118,3698
1971,永康里,2021,1520,3997,1899,2098
1972,光明里,2021,1494,4113,1990,2123
1973,錦泰里,2021,1445,4081,1962,2119
1974,錦華里,2021,2237,6234,2951,3283
1975,龍圖里,2021,2851,6799,3146,3653
1976,新龍里,2021,2677,7113,3354,3759
1977,龍陣里,2021,1468,3490,1647,1843
1978,龍雲里,2021,1893,4713,2152,2561
1979,龍生里,2021,2626,7044,3290,3754
1980,住安里,2021,2253,5006,2297,2709
1981,義安里,2021,2185,5290,2387,2903
1982,通化里,2021,2607,6199,2919,3280
1983,通安里,2021,2305,5401,2565,2836
1984,臨江里,2021,1769,4109,1939,2170
1985,法治里,2021,1867,4432,2066,2366
1986,全安里,2021,1848,4390,2031,2359
1987,群賢里,2021,2446,5751,2595,3156
1988,群英里,2021,2954,6831,3160,3671
1989,虎嘯里,2021,1702,3801,1754,2047
1990,臥龍里,2021,904,2377,1081,1296
1991,龍淵里,2021,3556,10169,4845,5324
1992,龍門里,2021,1656,4640,2146,2494
1993,大學里,2021,3558,8705,4037,4668
1994,芳和里,2021,2332,5788,2769,3019
1995,黎元里,2021,2105,5556,2664,2892
1996,黎孝里,2021,3035,7652,3613,4039
1997,黎和里,2021,1922,4520,2135,2385
1998,建安里,2021,2103,4901,2149,2752
1999,建倫里,2021,2444,6299,2792,3507
2000,敦安里,2021,2474,6498,2941,3557
2001,正聲里,2021,1908,4725,2189,2536
2002,敦煌里,2021,2382,6417,2923,3494
2003,華聲里,2021,1728,4263,1975,2288
2004,車層里,2021,2494,6357,2863,3494
2005,光信里,2021,3049,7791,3581,4210
2006,學府里,2021,1034,2691,1317,1374
2008,正守里,2021,1442,3267,1562,1705
2009,正義里,2021,2833,5237,2246,2991
2010,正得里,2021,2018,3649,1579,2070
2011,民安里,2021,2107,4493,2136,2357
2012,康樂里,2021,1529,2613,1093,1520
2013,中山里,2021,3849,6733,2864,3869
2014,聚盛里,2021,2409,4155,1804,2351
2015,集英里,2021,3354,7249,3273,3976
2016,聚葉里,2021,2049,3994,1816,2178
2017,恆安里,2021,2718,5067,2188,2879
2018,晴光里,2021,2977,5461,2348,3113
2019,圓山里,2021,1967,4234,1929,2305
2020,劍潭里,2021,1423,3724,1783,1941
2021,大直里,2021,3547,9295,4396,4899
2022,成功里,2021,2871,6931,3176,3755
2023,永安里,2021,3827,9669,4461,5208
2024,大佳里,2021,423,1084,593,491
2025,新喜里,2021,2139,5172,2422,2750
2026,新庄里,2021,2182,4874,2270,2604
2027,新福里,2021,2262,5188,2407,2781
2028,松江里,2021,2557,6500,3044,3456
2029,新生里,2021,2148,4743,2184,2559
2030,中庄里,2021,2279,4983,2368,2615
2031,行政里,2021,3888,7363,3784,3579
2032,行仁里,2021,3024,8029,3815,4214
2033,行孝里,2021,1694,4233,2013,2220
2034,下埤里,2021,3012,7470,3508,3962
2035,江寧里,2021,2846,6930,3277,3653
2036,江山里,2021,3116,7513,3581,3932
2037,中吉里,2021,2367,5805,2726,3079
2038,中原里,2021,2312,5159,2415,2744
2039,興亞里,2021,2532,5442,2506,2936
2040,中央里,2021,1591,3728,1743,1985
2041,朱馥里,2021,2540,5937,2716,3221
2042,龍洲里,2021,2135,4955,2276,2679
2043,朱園里,2021,2257,4619,2100,2519
2044,埤頭里,2021,1525,3257,1566,1691
2045,朱崙里,2021,1457,2954,1358,1596
2046,力行里,2021,2766,6162,2849,3313
2047,復華里,2021,2216,4774,2151,2623
2048,金泰里,2021,3495,8132,3912,4220
2049,北安里,2021,1022,2661,1265,1396
2051,水源里,2021,1388,3043,1410,1633
2052,富水里,2021,1052,2607,1267,1340
2053,文盛里,2021,1171,2606,1260,1346
2054,林興里,2021,2190,4775,2254,2521
2055,河堤里,2021,2009,4479,2126,2353
2056,頂東里,2021,2828,5954,2757,3197
2057,網溪里,2021,2502,5685,2632,3053
2058,板溪里,2021,1479,3192,1502,1690
2059,螢圃里,2021,2513,5504,2630,2874
2060,螢雪里,2021,1818,4259,2029,2230
2061,永功里,2021,2598,6284,3052,3232
2062,永昌里,2021,2058,4836,2361,2475
2063,龍興里,2021,1536,4015,1913,2102
2064,忠勤里,2021,2973,6204,2929,3275
2065,廈安里,2021,1916,4903,2330,2573
2066,愛國里,2021,1394,3446,1561,1885
2067,南門里,2021,1091,2851,1338,1513
2068,龍光里,2021,1317,3543,1743,1800
2069,南福里,2021,4868,12127,5843,6284
2070,龍福里,2021,2261,5664,2700,2964
2071,新營里,2021,3537,9769,4742,5027
2072,建國里,2021,746,1782,821,961
2073,光復里,2021,1915,3933,1860,2073
2074,黎明里,2021,1674,3541,1704,1837
2075,梅花里,2021,1383,3103,1442,1661
2076,幸福里,2021,2873,5755,2915,2840
2077,幸市里,2021,1917,4319,2050,2269
2078,東門里,2021,1668,3971,1921,2050
2079,文北里,2021,2327,5730,2702,3028
2080,文祥里,2021,3180,8442,3996,4446
2081,三愛里,2021,3576,8935,4104,4831
2083,玉泉里,2021,1241,2936,1437,1499
2084,建明里,2021,1500,3246,1551,1695
2085,建功里,2021,2068,4761,2257,2504
2086,建泰里,2021,1659,3854,1835,2019
2087,永樂里,2021,2197,5151,2570,2581
2088,朝陽里,2021,2011,4415,2099,2316
2089,星明里,2021,2631,6223,2942,3281
2090,光能里,2021,2062,5256,2542,2714
2091,大有里,2021,1871,4733,2302,2431
2092,延平里,2021,1906,4191,2011,2180
2093,雙連里,2021,3861,9622,4624,4998
2094,南芳里,2021,1721,4137,1919,2218
2095,民權里,2021,2579,6615,3153,3462
2096,景星里,2021,1144,2664,1335,1329
2097,隆和里,2021,1404,3420,1646,1774
2098,蓬萊里,2021,2122,4954,2360,2594
2099,國順里,2021,1055,2659,1369,1290
2100,國慶里,2021,1951,4671,2200,2471
2101,揚雅里,2021,2469,4506,2466,2040
2102,斯文里,2021,2053,4703,2295,2408
2103,鄰江里,2021,2651,6499,3219,3280
2104,至聖里,2021,3394,7883,3761,4122
2105,老師里,2021,2312,5834,2902,2932
2106,重慶里,2021,2643,6750,3198,3552
2107,保安里,2021,1651,3965,1941,2024
2109,福星里,2021,2744,5431,2575,2856
2110,萬壽里,2021,1847,3259,1563,1696
2111,西門里,2021,1994,3717,1709,2008
2112,新起里,2021,3260,6782,3197,3585
2113,菜園里,2021,2885,6215,3117,3098
2114,青山里,2021,2779,5823,2826,2997
2115,富民里,2021,2259,4832,2367,2465
2116,福音里,2021,1863,3926,1918,2008
2117,仁德里,2021,2156,4694,2262,2432
2118,富福里,2021,3216,5996,3306,2690
2119,頂碩里,2021,2952,7017,3528,3489
2120,雙園里,2021,1890,4633,2289,2344
2121,新忠里,2021,1574,3434,1604,1830
2122,新和里,2021,3436,8264,3933,4331
2123,糖?里,2021,2297,5433,2716,2717
2124,和平里,2021,2769,6658,3280,3378
2125,綠堤里,2021,1739,4285,2076,2209
2126,華江里,2021,3266,8397,4087,4310
2127,柳鄉里,2021,2086,5117,2507,2610
2128,日善里,2021,1417,3770,1861,1909
2129,新安里,2021,2643,6048,2955,3093
2130,忠德里,2021,1825,4525,2251,2274
2131,孝德里,2021,1244,3204,1583,1621
2132,和德里,2021,2639,6531,3264,3267
2133,錦德里,2021,2194,5527,2657,2870
2134,全德里,2021,1765,4407,2201,2206
2135,保德里,2021,1266,3227,1604,1623
2136,銘德里,2021,1837,4614,2249,2365
2137,榮德里,2021,1380,3583,1808,1775
2138,壽德里,2021,1928,5066,2511,2555
2139,興德里,2021,1761,4663,2307,2356
2140,華中里,2021,2439,6127,2969,3158
2141,日祥里,2021,2747,6045,2928,3117
2142,忠貞里,2021,2284,4765,2218,2547
2143,凌霄里,2021,1624,3593,1673,1920
2144,騰雲里,2021,1328,3017,1429,1588
2146,景行里,2021,3513,8285,3879,4406
2147,景東里,2021,2976,7520,3514,4006
2148,景美里,2021,2088,5341,2503,2838
2149,景慶里,2021,2533,6689,3167,3522
2150,景仁里,2021,2427,5861,2751,3110
2151,景華里,2021,2270,5937,2805,3132
2152,萬有里,2021,2217,5702,2751,2951
2153,萬祥里,2021,1877,4664,2198,2466
2154,萬隆里,2021,2931,7395,3471,3924
2155,萬年里,2021,2275,5309,2553,2756
2156,萬和里,2021,1460,3349,1613,1736
2157,萬盛里,2021,2053,4674,2238,2436
2158,興豐里,2021,2101,5051,2412,2639
2159,興光里,2021,1540,3535,1621,1914
2160,興家里,2021,2917,7543,3659,3884
2161,興得里,2021,2489,5976,2862,3114
2162,興業里,2021,2145,5394,2554,2840
2163,興安里,2021,2794,6926,3259,3667
2164,興福里,2021,2150,5844,2772,3072
2165,興旺里,2021,3457,8355,3998,4357
2166,興泰里,2021,1796,4039,1891,2148
2167,興昌里,2021,2809,6661,3134,3527
2168,試院里,2021,2809,6896,3281,3615
2169,華興里,2021,3671,9186,4422,4764
2170,明義里,2021,1866,4637,2197,2440
2171,明興里,2021,2797,6821,3274,3547
2172,木柵里,2021,3710,9114,4285,4829
2173,木新里,2021,4575,10111,5113,4998
2174,順興里,2021,2902,7616,3656,3960
2175,樟林里,2021,3256,8444,4108,4336
2176,樟新里,2021,2200,5687,2674,3013
2177,樟腳里,2021,2108,5653,2727,2926
2178,萬芳里,2021,3123,7939,3741,4198
2179,博嘉里,2021,2303,6052,2901,3151
2180,萬興里,2021,3328,8689,4193,4496
2181,指南里,2021,1768,4115,2097,2018
2182,老泉里,2021,362,913,478,435
2183,忠順里,2021,1783,4219,1989,2230
2184,萬美里,2021,2920,7357,3518,3839
2185,政大里,2021,3027,8124,3927,4197
2186,樟文里,2021,2375,6295,3038,3257
2187,興邦里,2021,2194,5022,2379,2643
2188,樟樹里,2021,1825,4890,2324,2566
2190,南港里,2021,2956,6777,3467,3310
2191,中南里,2021,1480,3711,1834,1877
2192,新富里,2021,1566,3953,1937,2016
2193,三重里,2021,3684,8017,3875,4142
2194,東新里,2021,2794,7375,3644,3731
2195,新光里,2021,1494,3703,1757,1946
2196,東明里,2021,2496,5710,2781,2929
2197,西新里,2021,1834,4792,2303,2489
2198,玉成里,2021,2031,4860,2393,2467
2199,合成里,2021,2749,6661,3241,3420
2200,成福里,2021,2973,7630,3657,3973
2201,萬福里,2021,1722,4216,2010,2206
2202,鴻福里,2021,1743,4472,2128,2344
2203,百福里,2021,2141,5399,2599,2800
2204,聯成里,2021,1999,5034,2447,2587
2205,舊莊里,2021,3542,8925,4350,4575
2206,中研里,2021,3643,9615,4746,4869
2207,九如里,2021,2532,6576,3227,3349
2208,仁福里,2021,2244,5591,2758,2833
2209,重陽里,2021,2380,5531,2639,2892
2211,西湖里,2021,2799,7046,3421,3625
2212,西康里,2021,3886,9533,4491,5042
2213,西安里,2021,2591,6601,3131,3470
2214,港墘里,2021,2399,6278,2954,3324
2215,港都里,2021,2191,5895,2822,3073
2216,港富里,2021,3653,9764,4705,5059
2217,港華里,2021,3476,9848,4660,5188
2218,內湖里,2021,2879,6283,2878,3405
2219,湖濱里,2021,3340,8551,4017,4534
2220,紫星里,2021,3064,8014,3836,4178
2221,大湖里,2021,2182,5539,2594,2945
2222,金龍里,2021,2095,5393,2634,2759
2223,金瑞里,2021,2678,7006,3294,3712
2224,碧山里,2021,2758,7172,3472,3700
2225,紫雲里,2021,2249,5806,2777,3029
2226,清白里,2021,3776,8626,4030,4596
2227,葫洲里,2021,2790,7785,3670,4115
2228,紫陽里,2021,3281,8123,3880,4243
2229,瑞陽里,2021,3114,7611,3583,4028
2230,瑞光里,2021,1776,4557,2114,2443
2231,五分里,2021,4136,11641,5533,6108
2232,東湖里,2021,2903,7945,3822,4123
2233,樂康里,2021,3094,8625,4117,4508
2234,內溝里,2021,1843,4796,2344,2452
2235,週美里,2021,3849,9060,4354,4706
2236,行善里,2021,2994,7199,3497,3702
2237,石潭里,2021,1953,4021,1898,2123
2238,湖興里,2021,4151,8591,4285,4306
2239,湖元里,2021,2101,5431,2635,2796
2240,安湖里,2021,2737,8131,3877,4254
2241,秀湖里,2021,2449,6181,2961,3220
2242,安泰里,2021,2092,5589,2727,2862
2243,金湖里,2021,3984,10386,4814,5572
2244,康寧里,2021,3198,9447,4499,4948
2245,明湖里,2021,2046,5971,2849,3122
2246,蘆洲里,2021,508,1380,740,640
2247,麗山里,2021,2365,6279,2975,3304
2248,寶湖里,2021,4240,9760,4614,5146
2249,南湖里,2021,2241,6111,2847,3264
2251,仁勇里,2021,1571,3898,1875,2023
2252,義信里,2021,1387,3238,1573,1665
2253,福林里,2021,1250,2931,1422,1509
2254,福德里,2021,2975,5785,3032,2753
2255,福志里,2021,3053,7633,3627,4006
2256,舊佳里,2021,2501,6182,2952,3230
2257,福佳里,2021,3021,7900,3789,4111
2258,後港里,2021,3117,8243,4064,4179
2259,福中里,2021,2597,6987,3388,3599
2260,前港里,2021,1713,4602,2225,2377
2261,百齡里,2021,2518,7096,3425,3671
2262,承德里,2021,2344,5601,2619,2982
2263,福華里,2021,2558,6264,2987,3277
2264,明勝里,2021,1985,4914,2354,2560
2265,福順里,2021,2159,5519,2725,2794
2266,富光里,2021,2203,6037,2957,3080
2267,葫蘆里,2021,2846,7702,3681,4021
2268,葫東里,2021,1623,4229,2044,2185
2269,社子里,2021,2491,6591,3261,3330
2270,社新里,2021,3470,9225,4611,4614
2271,社園里,2021,2675,7454,3750,3704
2272,永倫里,2021,2772,7128,3555,3573
2273,福安里,2021,2076,5068,2662,2406
2274,富洲里,2021,3054,6291,3253,3038
2275,岩山里,2021,1256,3401,1623,1778
2276,名山里,2021,2670,7198,3336,3862
2277,德行里,2021,1949,4526,2124,2402
2278,德華里,2021,2284,5756,2667,3089
2279,聖山里,2021,1950,5149,2415,2734
2280,忠誠里,2021,2185,5591,2622,2969
2281,芝山里,2021,2820,7738,3665,4073
2282,東山里,2021,1819,5212,2500,2712
2283,三玉里,2021,2180,5809,2716,3093
2284,蘭雅里,2021,3384,8906,4143,4763
2285,蘭興里,2021,2464,6488,3015,3473
2286,天福里,2021,2406,6544,3039,3505
2287,天祿里,2021,1971,5321,2501,2820
2288,天壽里,2021,1989,5252,2401,2851
2289,天和里,2021,2772,7708,3667,4041
2290,天山里,2021,2697,7096,3287,3809
2291,天玉里,2021,3450,9068,4182,4886
2292,天母里,2021,2564,6828,3216,3612
2293,永福里,2021,463,1256,614,642
2294,公館里,2021,536,1407,728,679
2295,新安里,2021,743,1893,935,958
2296,陽明里,2021,1462,3059,1477,1582
2297,菁山里,2021,588,1591,869,722
2298,平等里,2021,547,1502,759,743
2299,溪山里,2021,593,1550,787,763
2300,翠山里,2021,1184,2654,1249,1405
2301,臨溪里,2021,1196,2912,1413,1499
2303,建民里,2021,1834,4389,2127,2262
2304,文林里,2021,1768,4337,2087,2250
2305,石牌里,2021,2102,5294,2486,2808
2306,福興里,2021,2769,7486,3552,3934
2307,榮光里,2021,2849,7980,3795,4185
2308,榮華里,2021,2938,7467,3499,3968
2309,裕民里,2021,3158,7873,3726,4147
2310,振華里,2021,2932,7763,3664,4099
2311,永和里,2021,3747,9454,4449,5005
2312,永欣里,2021,3607,8503,3913,4590
2313,永明里,2021,1904,5246,2447,2799
2314,東華里,2021,1694,4707,2239,2468
2315,吉利里,2021,2629,7431,3497,3934
2316,吉慶里,2021,1932,5455,2588,2867
2317,尊賢里,2021,1789,5026,2364,2662
2318,立賢里,2021,2091,5867,2808,3059
2319,立農里,2021,3493,9603,4582,5021
2320,八仙里,2021,2189,5518,2675,2843
2321,洲美里,2021,879,2441,1210,1231
2322,奇岩里,2021,4411,10940,5285,5655
2323,清江里,2021,4430,9581,4889,4692
2324,中央里,2021,3369,8443,4079,4364
2325,長安里,2021,2771,6308,2935,3373
2326,大同里,2021,2297,5656,2758,2898
2327,溫泉里,2021,2772,6600,3131,3469
2328,林泉里,2021,1449,3050,1507,1543
2329,中心里,2021,3101,6459,2956,3503
2330,中庸里,2021,1700,4169,2007,2162
2331,開明里,2021,2673,6692,3201,3491
2332,中和里,2021,1953,4955,2378,2577
2333,智仁里,2021,2291,6198,2956,3242
2334,秀山里,2021,1215,3251,1576,1675
2335,文化里,2021,1655,4248,2057,2191
2336,豐年里,2021,1693,4641,2245,2396
2337,稻香里,2021,2220,5426,2685,2741
2338,桃源里,2021,2334,6015,2954,3061
2339,一德里,2021,2849,7571,3690,3881
2340,關渡里,2021,4242,11570,5629,5941
2341,泉源里,2021,861,2377,1234,1143
2342,湖山里,2021,694,1621,850,771
2343,大屯里,2021,448,1292,678,614
2344,湖田里,2021,376,926,503,423
