年,月,排名,隸屬區,里,鄰數,戶數,男,女,合計
106,12,1,林口區,湖南里,43,9410,10312,11363,21675
106,12,2,林口區,南勢里,40,8502,8898,9729,18627
106,12,3,三峽區,龍學里,45,6775,7401,8540,15941
106,12,4,樹林區,南園里,52,6487,7364,8089,15453
106,12,5,板橋區,溪福里,46,5163,7489,7690,15179
106,12,6,蘆洲區,正義里,25,5116,6747,7367,14114
106,12,7,淡水區,崁頂里,15,6713,6408,6874,13282
106,12,8,新店區,公崙里,37,4765,5933,6315,12248
106,12,9,新莊區,西盛里,29,4427,5922,6071,11993
106,12,10,新莊區,立廷里,40,4675,5649,6275,11924
106,12,11,新莊區,雙鳳里,36,4378,5750,5875,11625
106,12,12,蘆洲區,水湳里,25,3853,5427,5633,11060
106,12,13,板橋區,忠翠里,28,4434,5189,5814,11003
106,12,14,新莊區,中原里,33,4192,5297,5686,10983
106,12,15,淡水區,北投里,22,4676,5108,5661,10769
106,12,16,新店區,香坡里,46,4667,5201,5506,10707
106,12,17,永和區,保順里,38,4365,4981,5720,10701
106,12,18,三峽區,鳶山里,28,3895,5328,5349,10677
106,12,19,淡水區,竿蓁里,26,5414,4869,5721,10590
106,12,20,板橋區,崑崙里,36,3720,5133,5359,10492
106,12,21,林口區,西林里,35,4000,5027,5098,10125
106,12,22,三峽區,龍埔里,36,3686,4911,5025,9936
106,12,23,泰山區,全興里,25,3804,4799,5069,9868
106,12,24,林口區,麗林里,32,3762,4648,5162,9810
106,12,25,蘆洲區,水河里,18,3353,4806,4963,9769
106,12,26,樹林區,柑園里,37,4048,4712,5048,9760
106,12,27,三重區,過田里,28,5163,5326,4342,9668
106,12,28,新莊區,龍鳳里,30,3617,4538,5059,9597
106,12,29,中和區,平河里,67,3812,4625,4944,9569
106,12,30,新莊區,中平里,23,3466,4408,5115,9523
106,12,31,新店區,柴埕里,34,3637,4550,4843,9393
106,12,32,板橋區,深丘里,32,3735,4521,4850,9371
106,12,33,新莊區,中信里,34,3153,4526,4798,9324
106,12,34,鶯歌區,永昌里,22,2904,4606,4674,9280
106,12,35,板橋區,社後里,28,4877,5074,4040,9114
106,12,36,板橋區,重慶里,38,3282,4444,4656,9100
106,12,37,新莊區,丹鳳里,28,3428,4430,4657,9087
106,12,38,泰山區,義仁里,39,3253,4468,4485,8953
106,12,39,土城區,埤林里,38,3151,4324,4612,8936
106,12,40,新店區,張北里,32,3900,4233,4686,8919
106,12,41,淡水區,新春里,15,3578,4258,4609,8867
106,12,42,土城區,永寧里,37,3201,4373,4369,8742
106,12,43,中和區,積穗里,45,3466,4123,4424,8547
106,12,44,板橋區,海山里,23,2857,4071,4463,8534
106,12,45,中和區,新南里,49,3563,3944,4556,8500
106,12,46,土城區,清水里,32,2938,4130,4368,8498
106,12,47,鶯歌區,二橋里,26,2907,4320,4175,8495
106,12,48,新莊區,頭前里,16,3684,4123,4353,8476
106,12,49,三重區,溪美里,22,3331,4102,4343,8445
106,12,50,五股區,水碓里,36,2898,4076,4098,8174
106,12,51,汐止區,忠孝里,38,3637,3933,4206,8139
106,12,52,板橋區,新翠里,29,3086,3915,4210,8125
106,12,53,五股區,成泰里,34,3398,4113,3950,8063
106,12,54,三峽區,安溪里,38,2810,3972,4048,8020
106,12,55,新莊區,光華里,28,2729,3925,4079,8004
106,12,56,蘆洲區,成功里,29,2619,3856,4143,7999
106,12,57,三峽區,永舘里,25,2795,3788,4121,7909
106,12,58,三重區,光明里,30,3060,3845,4047,7892
106,12,59,土城區,峯廷里,31,2660,3928,3950,7878
106,12,60,三重區,碧華里,16,3524,3761,4082,7843
106,12,61,新店區,安和里,28,3083,3798,4023,7821
106,12,62,鶯歌區,尖山里,16,2684,3921,3891,7812
106,12,63,板橋區,華江里,30,3197,3625,4184,7809
106,12,64,汐止區,厚德里,30,3060,3763,3867,7630
106,12,65,板橋區,德翠里,26,2715,3721,3899,7620
106,12,66,淡水區,新興里,8,3234,3547,4059,7606
106,12,67,永和區,保安里,34,2978,3600,3998,7598
106,12,68,中和區,華新里,48,2876,3642,3949,7591
106,12,69,八里區,舊城里,22,2834,3696,3877,7573
106,12,70,汐止區,中興里,32,3465,3689,3881,7570
106,12,71,新莊區,裕民里,32,2653,3744,3804,7548
106,12,72,板橋區,華東里,32,3207,3646,3871,7517
106,12,73,新店區,五峯里,25,3187,3511,4006,7517
106,12,74,中和區,外南里,31,4122,4188,3293,7481
106,12,75,林口區,仁愛里,30,2833,3521,3929,7450
106,12,76,新店區,寶福里,29,3213,3605,3840,7445
106,12,77,八里區,龍源里,30,3194,3589,3811,7400
106,12,78,板橋區,華德里,32,2961,3564,3831,7395
106,12,79,淡水區,大庄里,12,3579,3447,3933,7380
106,12,80,蘆洲區,永康里,22,2464,3530,3847,7377
106,12,81,新莊區,後港里,31,2549,3571,3780,7351
106,12,82,土城區,平和里,34,2459,3619,3714,7333
106,12,83,鶯歌區,建國里,34,2500,3571,3753,7324
106,12,84,三芝區,埔坪里,35,2895,3674,3630,7304
106,12,85,汐止區,復興里,24,3314,3362,3925,7287
106,12,86,淡水區,民生里,32,3432,3319,3968,7287
106,12,87,土城區,清溪里,53,2747,3582,3662,7244
106,12,88,中和區,中興里,38,2791,3451,3703,7154
106,12,89,泰山區,山腳里,45,2476,3605,3541,7146
106,12,90,板橋區,廣德里,25,2619,3446,3646,7092
106,12,91,三峽區,介壽里,28,2603,3569,3470,7039
106,12,92,新莊區,建安里,34,2510,3359,3601,6960
106,12,93,板橋區,成和里,22,2541,3424,3524,6948
106,12,94,中和區,員山里,42,2779,3377,3562,6939
106,12,95,中和區,德行里,42,2829,3337,3590,6927
106,12,96,淡水區,福德里,20,3393,3317,3598,6915
106,12,97,三峽區,龍恩里,31,2877,3313,3592,6905
106,12,98,新莊區,中港里,28,2204,3287,3525,6812
106,12,99,土城區,延和里,32,2485,3242,3569,6811
106,12,100,樹林區,保安里,34,2393,3384,3367,6751
106,12,101,新莊區,昌平里,21,3105,3162,3581,6743
106,12,102,蘆洲區,永樂里,27,2227,3362,3358,6720
106,12,103,三重區,田中里,30,2337,3289,3411,6700
106,12,104,中和區,連城里,48,2612,3187,3496,6683
106,12,105,新店區,新安里,25,3789,3468,3174,6642
106,12,106,蘆洲區,樓厝里,24,2449,3225,3400,6625
106,12,107,三重區,成功里,21,2769,3134,3446,6580
106,12,108,新店區,中正里,24,2694,3047,3530,6577
106,12,109,土城區,清和里,28,2251,3299,3256,6555
106,12,110,新店區,德安里,28,2310,3264,3276,6540
106,12,111,三重區,光陽里,33,2605,3219,3300,6519
106,12,112,三重區,富貴里,32,2780,3082,3435,6517
106,12,113,林口區,東勢里,39,2320,3167,3349,6516
106,12,114,中和區,秀景里,43,2870,3177,3332,6509
106,12,115,三重區,田安里,42,2428,3129,3376,6505
106,12,116,新莊區,立基里,32,2332,3125,3351,6476
106,12,117,深坑區,埔新里,57,2620,3133,3336,6469
106,12,118,板橋區,埔墘里,23,2573,3078,3383,6461
106,12,119,土城區,金城里,26,2392,3065,3396,6461
106,12,120,蘆洲區,恆德里,21,2552,3137,3313,6450
106,12,121,中和區,力行里,45,2487,3081,3354,6435
106,12,122,汐止區,福安里,16,2437,3079,3353,6432
106,12,123,汐止區,湖興里,38,2963,3186,3243,6429
106,12,124,五股區,成功里,34,2495,3221,3182,6403
106,12,125,淡水區,竹圍里,15,2977,2881,3499,6380
106,12,126,樹林區,東陽里,31,2252,3222,3158,6380
106,12,127,五股區,成州里,27,2249,3245,3127,6372
106,12,128,新莊區,民安里,33,2113,3049,3303,6352
106,12,129,新店區,信義里,31,3068,3034,3314,6348
106,12,130,蘆洲區,南港里,20,2084,3098,3244,6342
106,12,131,三重區,永豐里,32,2150,3113,3229,6342
106,12,132,淡水區,鄧公里,17,2644,2962,3366,6328
106,12,133,汐止區,江北里,30,2526,3238,3067,6305
106,12,134,樹林區,彭興里,41,2116,3141,3156,6297
106,12,135,板橋區,港嘴里,25,2429,3096,3199,6295
106,12,136,板橋區,溪洲里,21,2200,3062,3232,6294
106,12,137,新莊區,中美里,24,2238,3029,3241,6270
106,12,138,板橋區,溪頭里,25,2428,3095,3171,6266
106,12,139,板橋區,懷翠里,26,2253,3075,3183,6258
106,12,140,新莊區,瓊林里,20,2153,3139,3106,6245
106,12,141,新店區,玫瑰里,28,2322,2983,3224,6207
106,12,142,鶯歌區,中湖里,27,2056,3201,2996,6197
106,12,143,淡水區,水碓里,20,2309,2995,3189,6184
106,12,144,三重區,永發里,27,2185,3096,3059,6155
106,12,145,鶯歌區,南鶯里,34,2141,3000,3128,6128
106,12,146,土城區,員林里,34,2378,2978,3150,6128
106,12,147,新店區,日興里,29,2275,3067,3038,6105
106,12,148,土城區,日和里,31,2192,2987,3104,6091
106,12,149,蘆洲區,玉清里,21,2264,2956,3123,6079
106,12,150,三峽區,礁溪里,37,2258,2975,3099,6074
106,12,151,新莊區,福興里,17,2124,3073,2998,6071
106,12,152,中和區,安平里,43,2711,2877,3179,6056
106,12,153,蘆洲區,中原里,29,2116,2973,3074,6047
106,12,154,新店區,新生里,26,2603,2827,3213,6040
106,12,155,新店區,雙城里,29,2211,3057,2981,6038
106,12,156,土城區,明德里,30,2384,2787,3227,6014
106,12,157,樹林區,山佳里,21,1940,3051,2939,5990
106,12,158,土城區,廣福里,33,2089,2949,3041,5990
106,12,159,三重區,六福里,29,2022,2941,3031,5972
106,12,160,新店區,永平里,17,2188,2859,3078,5937
106,12,161,新店區,中央里,20,2631,2734,3154,5888
106,12,162,三重區,永清里,32,2030,2846,3037,5883
106,12,163,林口區,林口里,29,2155,2880,2982,5862
106,12,164,土城區,員仁里,33,2022,2878,2968,5846
106,12,165,中和區,中原里,24,2479,2849,2994,5843
106,12,166,汐止區,湖光里,30,2853,2801,3036,5837
106,12,167,中和區,錦和里,21,2055,2853,2982,5835
106,12,168,汐止區,新昌里,35,2307,2855,2972,5827
106,12,169,蘆洲區,鷺江里,21,2050,2836,2981,5817
106,12,170,新莊區,信義里,25,2079,2803,3006,5809
106,12,171,土城區,裕生里,39,2144,2815,2965,5780
106,12,172,金山區,金美里,35,1920,2754,3022,5776
106,12,173,土城區,員福里,28,2094,2891,2877,5768
106,12,174,三重區,福祉里,20,2304,2789,2978,5767
106,12,175,蘆洲區,仁德里,20,1968,2846,2914,5760
106,12,176,中和區,瓦磘里,29,2260,2782,2963,5745
106,12,177,新莊區,自立里,26,2201,2722,3023,5745
106,12,178,三重區,永福里,30,2015,2782,2962,5744
106,12,179,汐止區,秀峰里,23,2674,2989,2718,5707
106,12,180,新莊區,思源里,22,2115,2775,2925,5700
106,12,181,蘆洲區,九芎里,27,1937,2782,2913,5695
106,12,182,中和區,景福里,44,2502,2678,3012,5690
106,12,183,新店區,江陵里,23,2357,2682,3005,5687
106,12,184,新莊區,海山里,24,2123,2741,2941,5682
106,12,185,板橋區,純翠里,15,2101,2775,2900,5675
106,12,186,淡水區,油車里,20,2323,2747,2910,5657
106,12,187,板橋區,玉光里,21,2204,2671,2978,5649
106,12,188,板橋區,聚安里,28,2019,2827,2800,5627
106,12,189,三芝區,埔頭里,42,2208,2742,2884,5626
106,12,190,板橋區,湳興里,25,2327,2689,2932,5621
106,12,191,新店區,安昌里,17,2388,2611,3004,5615
106,12,192,樹林區,中山里,25,1899,2853,2751,5604
106,12,193,汐止區,北山里,25,2605,2640,2963,5603
106,12,194,土城區,永富里,27,1971,2750,2834,5584
106,12,195,三峽區,中正里,34,1766,2795,2773,5568
106,12,196,淡水區,八勢里,14,2972,2469,3088,5557
106,12,197,新店區,青潭里,22,2259,2686,2869,5555
106,12,198,中和區,景平里,43,2495,2616,2938,5554
106,12,199,板橋區,華中里,20,1933,2783,2765,5548
106,12,200,土城區,頂福里,25,2058,2795,2746,5541
106,12,201,三重區,永順里,36,1909,2671,2862,5533
106,12,202,土城區,埤塘里,17,2826,3183,2345,5528
106,12,203,新店區,寶安里,39,2617,2559,2969,5528
106,12,204,五股區,德音里,30,1973,2734,2789,5523
106,12,205,三重區,大有里,25,1995,2749,2772,5521
106,12,206,蘆洲區,仁愛里,19,1838,2729,2790,5519
106,12,207,樹林區,文林里,36,1901,2707,2812,5519
106,12,208,新莊區,南港里,22,1969,2708,2802,5510
106,12,209,樹林區,彭福里,33,1964,2754,2756,5510
106,12,210,中和區,文元里,35,2043,2694,2803,5497
106,12,211,蘆洲區,仁義里,18,2658,2972,2525,5497
106,12,212,三重區,五華里,18,2097,2650,2842,5492
106,12,213,中和區,南山里,38,2219,2650,2809,5459
106,12,214,蘆洲區,光華里,19,1950,2594,2854,5448
106,12,215,樹林區,樹西里,32,2037,2678,2754,5432
106,12,216,新店區,美潭里,20,2149,2626,2796,5422
106,12,217,蘆洲區,長安里,19,1806,2703,2710,5413
106,12,218,蘆洲區,永安里,19,1833,2621,2789,5410
106,12,219,永和區,福和里,23,2313,2531,2870,5401
106,12,220,新莊區,立言里,24,1870,2578,2822,5400
106,12,221,板橋區,福德里,28,2004,2693,2706,5399
106,12,222,新店區,寶興里,24,2482,2566,2831,5397
106,12,223,新店區,永安里,25,2003,2624,2772,5396
106,12,224,土城區,樂利里,36,1986,2649,2746,5395
106,12,225,鶯歌區,大湖里,24,1927,2732,2657,5389
106,12,226,新店區,中興里,18,2328,2548,2839,5387
106,12,227,中和區,復興里,55,2087,2528,2853,5381
106,12,228,板橋區,自強里,35,2056,2612,2764,5376
106,12,229,汐止區,建成里,23,2350,2495,2879,5374
106,12,230,樹林區,獇寮里,27,1852,2674,2698,5372
106,12,231,新莊區,成德里,23,1811,2578,2777,5355
106,12,232,中和區,內南里,39,1846,2720,2632,5352
106,12,233,樹林區,彭厝里,40,1752,2642,2703,5345
106,12,234,永和區,中溪里,21,2088,2630,2702,5332
106,12,235,汐止區,崇德里,29,2118,2645,2686,5331
106,12,236,新莊區,全泰里,27,1942,2619,2704,5323
106,12,237,三重區,永德里,34,1916,2600,2706,5306
106,12,238,鶯歌區,永吉里,32,1645,2648,2643,5291
106,12,239,板橋區,龍翠里,20,2019,2559,2723,5282
106,12,240,中和區,福祥里,38,2101,2570,2691,5261
106,12,241,新店區,員潭里,19,2229,2591,2667,5258
106,12,242,汐止區,自強里,25,2190,2547,2708,5255
106,12,243,中和區,華南里,24,2112,2577,2672,5249
106,12,244,土城區,安和里,28,1846,2580,2647,5227
106,12,245,土城區,頂埔里,31,1984,2581,2644,5225
106,12,246,汐止區,拱北里,31,2122,2659,2560,5219
106,12,247,永和區,秀和里,21,2063,2475,2721,5196
106,12,248,板橋區,中山里,32,2143,2529,2667,5196
106,12,249,蘆洲區,光明里,23,1782,2548,2643,5191
106,12,250,樹林區,三興里,31,1832,2653,2535,5188
106,12,251,泰山區,貴和里,42,1948,2589,2599,5188
106,12,252,中和區,自強里,25,1911,2584,2603,5187
106,12,253,中和區,民安里,25,1876,2585,2594,5179
106,12,254,汐止區,金龍里,37,2347,2520,2650,5170
106,12,255,板橋區,民族里,20,1802,2485,2679,5164
106,12,256,中和區,秀明里,56,2383,2402,2756,5158
106,12,257,樹林區,東昇里,28,1807,2545,2612,5157
106,12,258,樹林區,潭底里,33,2101,2803,2344,5147
106,12,259,汐止區,康福里,24,2664,2395,2734,5129
106,12,260,新莊區,立泰里,21,1841,2475,2647,5122
106,12,261,永和區,和平里,24,2109,2431,2669,5100
106,12,262,土城區,廷寮里,23,1716,2539,2557,5096
106,12,263,萬里區,萬里里,35,1470,2505,2577,5082
106,12,264,土城區,學士里,27,1800,2456,2622,5078
106,12,265,新莊區,光明里,21,1604,2459,2614,5073
106,12,266,永和區,潭安里,20,2016,2437,2626,5063
106,12,267,永和區,保平里,25,1977,2401,2661,5062
106,12,268,土城區,大安里,25,1971,2525,2526,5051
106,12,269,板橋區,福丘里,19,2241,2345,2706,5051
106,12,270,中和區,忠孝里,39,1855,2506,2541,5047
106,12,271,永和區,民樂里,22,1968,2464,2575,5039
106,12,272,板橋區,港德里,29,1936,2482,2557,5039
106,12,273,泰山區,義學里,25,1721,2523,2500,5023
106,12,274,板橋區,長安里,19,1721,2424,2597,5021
106,12,275,中和區,佳和里,40,2114,2383,2627,5010
106,12,276,新莊區,忠孝里,29,1891,2463,2546,5009
106,12,277,永和區,永元里,21,1957,2306,2700,5006
106,12,278,新莊區,和平里,21,1754,2458,2528,4986
106,12,279,三重區,慈祐里,26,1791,2487,2488,4975
106,12,280,五股區,興珍里,40,1706,2580,2389,4969
106,12,281,板橋區,江翠里,20,1833,2463,2500,4963
106,12,282,板橋區,明翠里,22,1945,2407,2540,4947
106,12,283,永和區,豫溪里,17,2658,2533,2405,4938
106,12,284,板橋區,東丘里,20,1678,2399,2532,4931
106,12,285,板橋區,大豐里,22,1800,2398,2531,4929
106,12,286,板橋區,宏翠里,21,2176,2339,2589,4928
106,12,287,新店區,吉祥里,24,1826,2360,2566,4926
106,12,288,新莊區,榮和里,25,2836,2902,2012,4914
106,12,289,淡水區,新民里,12,2001,2373,2537,4910
106,12,290,汐止區,茄苳里,27,1770,2450,2460,4910
106,12,291,永和區,民族里,22,1908,2318,2592,4910
106,12,292,新莊區,四維里,22,1840,2376,2524,4900
106,12,293,土城區,日新里,27,1761,2434,2464,4898
106,12,294,八里區,訊塘里,23,1951,2446,2447,4893
106,12,295,新莊區,中隆里,27,1795,2363,2527,4890
106,12,296,中和區,秀福里,36,1960,2373,2499,4872
106,12,297,鶯歌區,鳳祥里,33,1674,2430,2439,4869
106,12,298,新莊區,光正里,22,1614,2407,2460,4867
106,12,299,三重區,博愛里,22,1669,2369,2495,4864
106,12,300,新莊區,光榮里,20,1543,2367,2484,4851
106,12,301,新莊區,中和里,30,1710,2375,2476,4851
106,12,302,鶯歌區,鳳鳴里,29,1581,2455,2390,4845
106,12,303,中和區,景安里,44,2017,2370,2470,4840
106,12,304,淡水區,學府里,18,2184,2313,2526,4839
106,12,305,新莊區,恆安里,24,1694,2336,2502,4838
106,12,306,淡水區,正德里,14,2046,2208,2626,4834
106,12,307,三重區,幸福里,36,1874,2374,2455,4829
106,12,308,三重區,福隆里,19,1825,2309,2520,4829
106,12,309,新店區,中山里,26,2301,2207,2612,4819
106,12,310,中和區,壽德里,31,1831,2285,2525,4810
106,12,311,永和區,潭墘里,25,1933,2205,2602,4807
106,12,312,新莊區,合鳳里,25,1677,2411,2393,4804
106,12,313,永和區,民權里,26,1762,2298,2484,4782
106,12,314,汐止區,城中里,28,2013,2216,2551,4767
106,12,315,中和區,安穗里,19,1835,2321,2441,4762
106,12,316,土城區,沛陂里,21,1844,2427,2330,4757
106,12,317,汐止區,智慧里,24,2184,2192,2561,4753
106,12,318,新莊區,中泰里,22,1793,2340,2412,4752
106,12,319,土城區,延壽里,27,1727,2388,2359,4747
106,12,320,蘆洲區,永德里,20,1573,2354,2392,4746
106,12,321,新莊區,全安里,22,1806,2296,2446,4742
106,12,322,土城區,復興里,34,1684,2339,2396,4735
106,12,323,泰山區,楓樹里,28,1708,2393,2335,4728
106,12,324,中和區,明穗里,33,1682,2349,2372,4721
106,12,325,新莊區,昌隆里,15,1701,2202,2502,4704
106,12,326,中和區,秀山里,31,1805,2254,2441,4695
106,12,327,板橋區,埤墘里,17,1782,2258,2436,4694
106,12,328,中和區,德穗里,32,1766,2288,2400,4688
106,12,329,汐止區,秀山里,26,1820,2301,2373,4674
106,12,330,林口區,菁湖里,23,1620,2296,2360,4656
106,12,331,五股區,德泰里,22,1683,2244,2407,4651
106,12,332,樹林區,圳福里,27,1588,2323,2325,4648
106,12,333,土城區,永豐里,27,1641,2277,2370,4647
106,12,334,汐止區,保長里,22,1965,2323,2317,4640
106,12,335,中和區,和興里,42,1880,2219,2417,4636
106,12,336,板橋區,新民里,26,1731,2262,2369,4631
106,12,337,五股區,五股里,28,1875,2399,2224,4623
106,12,338,汐止區,橫科里,42,2096,2270,2345,4615
106,12,339,土城區,員信里,25,1664,2265,2348,4613
106,12,340,新莊區,福基里,17,1995,2278,2325,4603
106,12,341,三重區,光田里,27,1947,2245,2358,4603
106,12,342,板橋區,振興里,17,1683,2255,2339,4594
106,12,343,金山區,美田里,25,1421,2178,2410,4588
106,12,344,中和區,廟美里,40,1757,2229,2359,4588
106,12,345,中和區,秀峰里,47,2092,2107,2480,4587
106,12,346,中和區,福美里,35,1712,2248,2328,4576
106,12,347,板橋區,堂春里,19,1509,2269,2306,4575
106,12,348,新莊區,幸福里,30,1646,2202,2365,4567
106,12,349,鶯歌區,北鶯里,20,1933,2306,2261,4567
106,12,350,中和區,嘉慶里,24,1669,2259,2299,4558
106,12,351,板橋區,新生里,24,1582,2271,2285,4556
106,12,352,樹林區,金寮里,24,1556,2279,2270,4549
106,12,353,汐止區,北峰里,26,1826,2312,2227,4539
106,12,354,土城區,延吉里,22,1573,2281,2253,4534
106,12,355,三重區,民生里,28,1744,2225,2308,4533
106,12,356,汐止區,白雲里,26,1864,2263,2265,4528
106,12,357,中和區,錦中里,22,1629,2201,2318,4519
106,12,358,新店區,中華里,21,1985,2137,2373,4510
106,12,359,土城區,貨饒里,22,1743,2223,2282,4505
106,12,360,板橋區,中正里,27,1615,2199,2301,4500
106,12,361,中和區,信和里,41,1646,2253,2244,4497
106,12,362,汐止區,文化里,21,1815,2180,2311,4491
106,12,363,林口區,東林里,27,1531,2269,2210,4479
106,12,364,淡水區,新義里,14,1554,2185,2294,4479
106,12,365,中和區,安順里,34,1971,2122,2355,4477
106,12,366,淡水區,民權里,17,2086,2067,2406,4473
106,12,367,新莊區,思賢里,21,1585,2205,2268,4473
106,12,368,永和區,得和里,25,1842,2107,2357,4464
106,12,369,中和區,中安里,40,2098,2087,2377,4464
106,12,370,板橋區,香社里,21,1592,2232,2230,4462
106,12,371,中和區,福南里,29,1572,2107,2348,4455
106,12,372,板橋區,莊敬里,14,1646,2163,2288,4451
106,12,373,三重區,永安里,20,1561,2175,2276,4451
106,12,374,林口區,中湖里,17,1567,2222,2226,4448
106,12,375,中和區,碧河里,27,1751,2170,2271,4441
106,12,376,中和區,仁和里,42,1564,2209,2228,4437
106,12,377,三重區,五常里,34,1481,2199,2232,4431
106,12,378,板橋區,信義里,21,1736,2180,2249,4429
106,12,379,板橋區,漢生里,22,1662,2149,2279,4428
106,12,380,土城區,延祿里,21,1577,2213,2212,4425
106,12,381,蘆洲區,延平里,17,1535,2200,2212,4412
106,12,382,三重區,仁華里,27,1693,2148,2254,4402
106,12,383,新店區,新和里,23,1759,2100,2285,4385
106,12,384,樹林區,樹南里,29,1559,2172,2210,4382
106,12,385,板橋區,僑中里,16,1512,2174,2207,4381
106,12,386,板橋區,振義里,19,1644,2138,2243,4381
106,12,387,板橋區,雙玉里,18,1572,2102,2264,4366
106,12,388,中和區,東南里,32,1770,2148,2215,4363
106,12,389,板橋區,五權里,19,1577,2196,2159,4355
106,12,390,樹林區,三多里,21,1466,2206,2146,4352
106,12,391,泰山區,同榮里,30,1485,2149,2198,4347
106,12,392,中和區,福真里,43,1733,2129,2212,4341
106,12,393,林口區,麗園里,19,1535,2145,2189,4334
106,12,394,中和區,福善里,42,1835,2051,2276,4327
106,12,395,板橋區,廣福里,12,1571,2111,2215,4326
106,12,396,三峽區,大埔里,22,1433,2296,2021,4317
106,12,397,樹林區,三福里,32,1523,2125,2178,4303
106,12,398,中和區,民生里,30,1764,2051,2244,4295
106,12,399,淡水區,幸福里,19,1652,2073,2220,4293
106,12,400,永和區,店街里,19,1898,1929,2363,4292
106,12,401,永和區,民生里,22,1557,2007,2279,4286
106,12,402,永和區,永安里,24,1807,1989,2289,4278
106,12,403,永和區,民本里,17,1623,2011,2263,4274
106,12,404,瑞芳區,爪峯里,14,1607,2108,2163,4271
106,12,405,板橋區,華興里,18,1611,2069,2200,4269
106,12,406,板橋區,忠誠里,17,1703,2062,2199,4261
106,12,407,三峽區,八張里,20,1516,2126,2132,4258
106,12,408,蘆洲區,信義里,27,1438,2122,2130,4252
106,12,409,蘆洲區,中路里,17,1441,2118,2132,4250
106,12,410,板橋區,柏翠里,18,1768,2025,2225,4250
106,12,411,淡水區,沙崙里,8,1802,2092,2156,4248
106,12,412,三重區,田心里,32,1605,2118,2127,4245
106,12,413,新店區,福民里,25,1823,1964,2271,4235
106,12,414,泰山區,同興里,24,1442,2063,2168,4231
106,12,415,中和區,中正里,34,1566,2057,2170,4227
106,12,416,中和區,嘉新里,22,1481,2099,2125,4224
106,12,417,新莊區,民有里,20,1540,2016,2202,4218
106,12,418,永和區,水源里,21,1668,2030,2183,4213
106,12,419,板橋區,浮洲里,25,1403,2145,2053,4198
106,12,420,板橋區,大安里,24,1528,2121,2074,4195
106,12,421,淡水區,中興里,18,1708,2023,2170,4193
106,12,422,樹林區,光興里,21,1415,2109,2083,4192
106,12,423,三重區,崇德里,32,1546,2117,2073,4190
106,12,424,永和區,秀朗里,23,1587,2048,2134,4182
106,12,425,板橋區,文翠里,19,1586,2060,2117,4177
106,12,426,三重區,五順里,35,1509,2078,2095,4173
106,12,427,新莊區,立志里,16,1524,2030,2143,4173
106,12,428,板橋區,金華里,23,1476,2028,2144,4172
106,12,429,中和區,崇南里,41,1739,1998,2172,4170
106,12,430,永和區,下溪里,15,1609,2018,2151,4169
106,12,431,新店區,明德里,27,1780,1951,2213,4164
106,12,432,汐止區,東勢里,22,2042,2044,2120,4164
106,12,433,板橋區,和平里,16,1654,1946,2210,4156
106,12,434,三重區,福德里,20,1710,1960,2175,4135
106,12,435,板橋區,福祿里,19,1589,1937,2196,4133
106,12,436,板橋區,幸福里,19,1520,2062,2071,4133
106,12,437,中和區,明德里,28,1563,2046,2086,4132
106,12,438,泰山區,貴子里,29,1592,2041,2086,4127
106,12,439,永和區,雙和里,17,1719,1885,2235,4120
106,12,440,樹林區,和平里,28,1428,2053,2055,4108
106,12,441,新店區,大同里,26,1781,1974,2132,4106
106,12,442,八里區,埤頭里,28,1551,2043,2060,4103
106,12,443,新店區,百忍里,22,1653,1917,2185,4102
106,12,444,中和區,錦盛里,26,1461,1996,2105,4101
106,12,445,五股區,集賢里,22,1416,2042,2054,4096
106,12,446,新店區,福德里,20,1648,1922,2170,4092
106,12,447,三重區,五福里,17,1661,1966,2117,4083
106,12,448,永和區,安和里,18,1738,1890,2188,4078
106,12,449,中和區,國光里,39,1503,1989,2084,4073
106,12,450,鶯歌區,鳳福里,29,1497,1992,2076,4068
106,12,451,板橋區,公館里,21,1483,2002,2064,4066
106,12,452,板橋區,文聖里,17,1438,1976,2070,4046
106,12,453,三重區,中興里,37,1564,2041,1998,4039
106,12,454,新莊區,昌信里,17,1438,1931,2100,4031
106,12,455,五股區,集福里,26,1517,2036,1975,4011
106,12,456,板橋區,香丘里,14,1472,1945,2049,3994
106,12,457,蘆洲區,保佑里,18,1378,1980,2001,3981
106,12,458,樹林區,樹興里,27,1420,1964,2014,3978
106,12,459,新店區,小城里,18,1448,1943,2026,3969
106,12,460,三重區,培德里,24,1453,1970,1994,3964
106,12,461,新莊區,民全里,17,1359,1961,1994,3955
106,12,462,三重區,清和里,20,1846,1868,2085,3953
106,12,463,新莊區,立功里,25,1423,1915,2037,3952
106,12,464,板橋區,後埔里,17,1604,1949,2001,3950
106,12,465,五股區,六福里,23,1437,1932,2011,3943
106,12,466,板橋區,大觀里,14,1343,1920,2022,3942
106,12,467,三重區,六合里,25,1488,1960,1981,3941
106,12,468,永和區,秀林里,20,1515,1910,2028,3938
106,12,469,泰山區,福興里,25,1418,1918,2020,3938
106,12,470,三重區,福樂里,23,1535,1952,1985,3937
106,12,471,新莊區,富民里,21,1453,1948,1984,3932
106,12,472,新店區,達觀里,21,1958,1839,2085,3924
106,12,473,新莊區,豐年里,16,1368,1927,1997,3924
106,12,474,新莊區,中宏里,20,1369,1922,1989,3911
106,12,475,鶯歌區,南靖里,20,1325,1987,1902,3889
106,12,476,三重區,厚德里,22,1463,1919,1969,3888
106,12,477,新莊區,萬安里,18,1486,1856,2032,3888
106,12,478,板橋區,吉翠里,16,1368,1908,1979,3887
106,12,479,新莊區,仁義里,20,1434,1951,1933,3884
106,12,480,泰山區,貴賢里,27,1513,1924,1960,3884
106,12,481,永和區,桂林里,18,1516,1847,2033,3880
106,12,482,泰山區,明志里,24,1359,1909,1956,3865
106,12,483,板橋區,鄉雲里,21,1571,1844,2019,3863
106,12,484,中和區,枋寮里,35,1524,1894,1968,3862
106,12,485,中和區,秀水里,28,1570,1851,2005,3856
106,12,486,三重區,重陽里,25,1435,1891,1959,3850
106,12,487,板橋區,華翠里,19,1396,1845,2000,3845
106,12,488,新店區,大豐里,24,1612,1794,2051,3845
106,12,489,樹林區,圳安里,23,1377,1927,1903,3830
106,12,490,永和區,竹林里,30,1543,1832,1997,3829
106,12,491,三重區,重明里,19,1474,1861,1959,3820
106,12,492,中和區,福和里,32,1499,1888,1932,3820
106,12,493,新莊區,昌明里,18,1324,1835,1982,3817
106,12,494,板橋區,國泰里,15,1456,1806,2007,3813
106,12,495,板橋區,國光里,20,1556,1836,1965,3801
106,12,496,樹林區,樹德里,25,1402,1888,1912,3800
106,12,497,板橋區,聯翠里,17,1657,1791,2001,3792
106,12,498,樹林區,樹福里,20,1465,1803,1987,3790
106,12,499,板橋區,廣新里,24,1295,1858,1930,3788
106,12,500,新莊區,中全里,18,1301,1909,1877,3786
106,12,501,土城區,學府里,22,1284,1814,1969,3783
106,12,502,泰山區,黎明里,17,1344,1845,1938,3783
106,12,503,板橋區,新海里,21,1255,1894,1860,3754
106,12,504,板橋區,溪北里,18,1353,1856,1893,3749
106,12,505,三峽區,二鬮里,24,1351,1901,1846,3747
106,12,506,中和區,漳和里,36,1575,1813,1933,3746
106,12,507,蘆洲區,復興里,13,1299,1866,1874,3740
106,12,508,萬里區,野柳里,19,1108,1810,1927,3737
106,12,509,五股區,五福里,23,1317,1902,1833,3735
106,12,510,板橋區,福星里,20,1360,1795,1938,3733
106,12,511,樹林區,大同里,18,1304,1778,1952,3730
106,12,512,中和區,建和里,34,1421,1827,1887,3714
106,12,513,板橋區,建國里,31,1433,1791,1923,3714
106,12,514,中和區,安樂里,33,1608,1736,1964,3700
106,12,515,中和區,正南里,30,1371,1857,1842,3699
106,12,516,新莊區,化成里,15,1357,1850,1845,3695
106,12,517,三重區,福田里,24,1257,1864,1828,3692
106,12,518,三重區,福民里,19,1365,1805,1883,3688
106,12,519,永和區,上林里,21,1513,1760,1926,3686
106,12,520,中和區,景新里,32,1468,1758,1918,3676
106,12,521,新莊區,興漢里,32,1399,1808,1860,3668
106,12,522,土城區,廣興里,18,1325,1739,1925,3664
106,12,523,新店區,百福里,24,1581,1693,1964,3657
106,12,524,新莊區,文聖里,29,1437,1709,1946,3655
106,12,525,中和區,秀成里,31,1386,1786,1868,3654
106,12,526,八里區,米倉里,24,1448,1859,1794,3653
106,12,527,板橋區,永安里,17,1412,1781,1869,3650
106,12,528,瑞芳區,新峰里,14,1325,1851,1799,3650
106,12,529,新店區,明城里,21,1408,1752,1896,3648
106,12,530,汐止區,福山里,18,1709,1705,1939,3644
106,12,531,三重區,慈愛里,25,1374,1783,1855,3638
106,12,532,中和區,泰安里,42,1458,1715,1914,3629
106,12,533,永和區,永貞里,20,1457,1697,1907,3604
106,12,534,五股區,民義里,23,1275,1797,1806,3603
106,12,535,土城區,柑林里,21,1379,1765,1837,3602
106,12,536,樹林區,樹人里,21,1239,1758,1829,3587
106,12,537,三重區,立德里,22,1318,1747,1838,3585
106,12,538,板橋區,景星里,24,1495,1700,1882,3582
106,12,539,三重區,三民里,15,1299,1774,1806,3580
106,12,540,樹林區,中華里,19,1244,1713,1855,3568
106,12,541,蘆洲區,樹德里,14,1280,1774,1788,3562
106,12,542,永和區,福林里,25,1441,1723,1837,3560
106,12,543,三重區,永盛里,25,1273,1727,1824,3551
106,12,544,板橋區,朝陽里,16,1272,1689,1856,3545
106,12,545,中和區,員富里,23,1375,1780,1761,3541
106,12,546,永和區,智光里,32,1389,1700,1836,3536
106,12,547,板橋區,文化里,17,1406,1719,1812,3531
106,12,548,中和區,景文里,29,1501,1698,1819,3517
106,12,549,蘆洲區,得勝里,21,1291,1709,1804,3513
106,12,550,板橋區,松翠里,18,1388,1696,1810,3506
106,12,551,蘆洲區,中華里,14,1255,1719,1783,3502
106,12,552,泰山區,新明里,25,1224,1747,1752,3499
106,12,553,新店區,復興里,21,1481,1677,1816,3493
106,12,554,中和區,冠穗里,24,1297,1766,1725,3491
106,12,555,深坑區,深坑里,41,1434,1739,1741,3480
106,12,556,瑞芳區,吉安里,16,1307,1757,1716,3473
106,12,557,汐止區,忠山里,22,1582,1662,1807,3469
106,12,558,中和區,國華里,22,1308,1706,1756,3462
106,12,559,板橋區,光復里,25,1364,1751,1707,3458
106,12,560,土城區,學成里,18,1174,1710,1739,3449
106,12,561,五股區,福德里,19,1283,1724,1716,3440
106,12,562,蘆洲區,福安里,11,1176,1682,1757,3439
106,12,563,樹林區,東山里,20,1156,1737,1700,3437
106,12,564,三重區,龍濱里,20,1249,1659,1776,3435
106,12,565,蘆洲區,忠義里,14,1207,1675,1758,3433
106,12,566,板橋區,居仁里,17,1233,1698,1730,3428
106,12,567,板橋區,福壽里,16,1270,1683,1739,3422
106,12,568,永和區,河堤里,19,1541,1616,1802,3418
106,12,569,新店區,國豐里,22,1432,1554,1857,3411
106,12,570,中和區,秀仁里,23,1431,1649,1758,3407
106,12,571,土城區,中正里,18,1254,1607,1800,3407
106,12,572,三重區,富華里,24,1324,1709,1684,3393
106,12,573,新店區,下城里,14,1386,1726,1657,3383
106,12,574,新店區,百和里,22,1411,1646,1731,3377
106,12,575,中和區,清穗里,24,1278,1705,1661,3366
106,12,576,蘆洲區,溪墘里,15,1193,1633,1727,3360
106,12,577,永和區,河濱里,19,1345,1632,1721,3353
106,12,578,永和區,永興里,26,1325,1571,1771,3342
106,12,579,板橋區,新興里,17,1517,1602,1735,3337
106,12,580,三重區,仁忠里,23,1260,1653,1679,3332
106,12,581,土城區,瑞興里,26,1260,1619,1677,3296
106,12,582,板橋區,仁愛里,20,1180,1630,1659,3289
106,12,583,中和區,興南里,37,1284,1591,1690,3281
106,12,584,汐止區,福德里,18,1467,1570,1704,3274
106,12,585,新莊區,八德里,16,1203,1591,1683,3274
106,12,586,中和區,景南里,34,1329,1565,1705,3270
106,12,587,三重區,尚德里,29,1227,1573,1691,3264
106,12,588,三峽區,中埔里,15,1199,1598,1660,3258
106,12,589,樹林區,育英里,20,1198,1589,1667,3256
106,12,590,永和區,民富里,15,1155,1583,1672,3255
106,12,591,新店區,太平里,20,1420,1555,1700,3255
106,12,592,新店區,粗坑里,20,1341,1538,1715,3253
106,12,593,三峽區,溪東里,16,1041,1682,1564,3246
106,12,594,板橋區,文德里,12,1177,1610,1635,3245
106,12,595,永和區,秀元里,20,1239,1554,1685,3239
106,12,596,蘆洲區,得仁里,15,1151,1576,1658,3234
106,12,597,五股區,成德里,23,1141,1625,1605,3230
106,12,598,板橋區,正泰里,16,1111,1529,1687,3216
106,12,599,土城區,青山里,18,1087,1610,1602,3212
106,12,600,萬里區,北基里,23,1444,1596,1614,3210
106,12,601,八里區,大崁里,17,1173,1662,1544,3206
106,12,602,五股區,貿商里,25,1248,1556,1647,3203
106,12,603,新店區,建國里,18,1336,1487,1714,3201
106,12,604,板橋區,介壽里,17,1229,1518,1669,3187
106,12,605,中和區,安和里,27,1378,1511,1668,3179
106,12,606,三重區,福安里,25,1272,1573,1605,3178
106,12,607,土城區,青雲里,21,1112,1548,1627,3175
106,12,608,三重區,永吉里,20,1209,1525,1649,3174
106,12,609,永和區,光明里,17,1317,1429,1731,3160
106,12,610,三重區,維德里,21,1177,1546,1611,3157
106,12,611,中和區,頂南里,26,1134,1525,1629,3154
106,12,612,深坑區,土庫里,36,1181,1573,1579,3152
106,12,613,萬里區,大鵬里,24,1017,1592,1559,3151
106,12,614,汐止區,橋東里,20,1235,1497,1643,3140
106,12,615,新莊區,民本里,19,1153,1595,1540,3135
106,12,616,中和區,吉興里,21,1291,1468,1664,3132
106,12,617,新莊區,後德里,15,1093,1566,1566,3132
106,12,618,板橋區,光仁里,15,1051,1553,1558,3111
106,12,619,板橋區,青翠里,15,1213,1608,1500,3108
106,12,620,中和區,正行里,19,1262,1469,1614,3083
106,12,621,板橋區,滿翠里,20,1145,1488,1592,3080
106,12,622,永和區,中興里,17,1341,1408,1668,3076
106,12,623,永和區,協和里,22,1307,1483,1582,3065
106,12,624,汐止區,興福里,20,1408,1472,1593,3065
106,12,625,永和區,秀成里,17,1199,1503,1559,3062
106,12,626,板橋區,港尾里,15,1114,1440,1609,3049
106,12,627,土城區,頂新里,10,1220,1460,1588,3048
106,12,628,永和區,民治里,24,1222,1371,1677,3048
106,12,629,板橋區,莒光里,17,1166,1484,1559,3043
106,12,630,新莊區,中華里,15,1204,1484,1552,3036
106,12,631,蘆洲區,保新里,12,1089,1507,1529,3036
106,12,632,板橋區,仁翠里,16,1110,1456,1557,3013
106,12,633,汐止區,宜興里,25,1456,1407,1600,3007
106,12,634,泰山區,福泰里,25,1056,1513,1491,3004
106,12,635,新莊區,光和里,19,966,1446,1557,3003
106,12,636,板橋區,九如里,16,1084,1421,1572,2993
106,12,637,板橋區,龍安里,20,1084,1442,1530,2972
106,12,638,板橋區,自立里,20,1097,1430,1522,2952
106,12,639,板橋區,長壽里,11,1041,1456,1487,2943
106,12,640,汐止區,保新里,13,1401,1424,1513,2937
106,12,641,三重區,大園里,22,1132,1469,1454,2923
106,12,642,樹林區,圳民里,16,1094,1518,1403,2921
106,12,643,汐止區,大同里,23,1279,1378,1533,2911
106,12,644,樹林區,太順里,16,948,1488,1412,2900
106,12,645,中和區,嘉穗里,15,1021,1442,1458,2900
106,12,646,板橋區,陽明里,17,1065,1417,1482,2899
106,12,647,淡水區,北新里,20,1370,1359,1537,2896
106,12,648,中和區,中山里,22,1104,1421,1473,2894
106,12,649,中和區,民有里,24,1110,1426,1457,2883
106,12,650,萬里區,龜吼里,20,972,1466,1416,2882
106,12,651,永和區,文化里,18,1206,1364,1515,2879
106,12,652,永和區,永福里,18,1157,1397,1478,2875
106,12,653,蘆洲區,民和里,15,1054,1421,1436,2857
106,12,654,淡水區,義山里,19,1126,1498,1354,2852
106,12,655,三重區,中山里,22,1204,1387,1462,2849
106,12,656,新店區,美城里,14,1087,1375,1472,2847
106,12,657,新莊區,自強里,15,1166,1443,1403,2846
106,12,658,板橋區,西安里,14,1049,1390,1455,2845
106,12,659,新店區,忠孝里,15,1287,1368,1473,2841
106,12,660,三重區,國隆里,26,1109,1367,1472,2839
106,12,661,永和區,秀得里,20,1068,1350,1474,2824
106,12,662,新莊區,仁愛里,20,1046,1364,1457,2821
106,12,663,烏來區,烏來里,15,880,1367,1441,2808
106,12,664,板橋區,華貴里,19,1029,1354,1448,2802
106,12,665,新店區,新德里,20,1203,1297,1493,2790
106,12,666,板橋區,光華里,20,1108,1373,1404,2777
106,12,667,深坑區,萬福里,30,1215,1405,1369,2774
106,12,668,永和區,仁愛里,17,1161,1320,1447,2767
106,12,669,汐止區,山光里,14,1134,1346,1420,2766
106,12,670,板橋區,民權里,24,1087,1358,1406,2764
106,12,671,蘆洲區,保和里,15,980,1368,1390,2758
106,12,672,板橋區,百壽里,17,1084,1316,1436,2752
106,12,673,板橋區,東安里,11,908,1352,1399,2751
106,12,674,中和區,秀義里,18,1093,1377,1366,2743
106,12,675,新莊區,立德里,17,997,1330,1410,2740
106,12,676,汐止區,湖蓮里,12,1428,1271,1459,2730
106,12,677,新店區,大鵬里,10,1282,1331,1396,2727
106,12,678,新店區,華城里,13,1242,1256,1466,2722
106,12,679,永和區,信義里,15,1234,1241,1476,2717
106,12,680,三重區,三安里,20,1212,1302,1411,2713
106,12,681,永和區,大新里,16,1215,1236,1471,2707
106,12,682,新店區,國校里,10,1131,1330,1371,2701
106,12,683,三重區,慈化里,17,937,1297,1383,2680
106,12,684,板橋區,光榮里,20,1022,1349,1321,2670
106,12,685,板橋區,香雅里,11,997,1309,1350,2659
106,12,686,新莊區,福營里,20,1111,1321,1325,2646
106,12,687,三重區,永煇里,16,962,1353,1287,2640
106,12,688,板橋區,福安里,25,1005,1298,1337,2635
106,12,689,新莊區,泰豐里,14,1020,1295,1338,2633
106,12,690,新莊區,自信里,12,967,1278,1353,2631
106,12,691,中和區,民享里,20,937,1287,1320,2607
106,12,692,三重區,光正里,22,1300,1278,1327,2605
106,12,693,新莊區,祥鳳里,18,915,1295,1308,2603
106,12,694,蘆洲區,忠孝里,12,834,1294,1308,2602
106,12,695,五股區,陸一里,35,1080,1274,1325,2599
106,12,696,新莊區,建福里,13,910,1300,1296,2596
106,12,697,深坑區,萬順里,24,1102,1294,1301,2595
106,12,698,板橋區,嵐翠里,12,973,1298,1290,2588
106,12,699,新店區,長春里,11,1135,1212,1364,2576
106,12,700,三重區,長元里,18,1032,1300,1270,2570
106,12,701,三峽區,嘉添里,21,792,1480,1087,2567
106,12,702,新店區,屈尺里,18,866,1323,1243,2566
106,12,703,永和區,頂溪里,16,1082,1212,1352,2564
106,12,704,永和區,永樂里,16,1141,1159,1402,2561
106,12,705,石門區,老梅里,19,850,1286,1253,2539
106,12,706,三重區,瑞德里,19,925,1250,1288,2538
106,12,707,新店區,忠誠里,20,1090,1218,1319,2537
106,12,708,新莊區,龍安里,15,845,1262,1274,2536
106,12,709,中和區,瑞穗里,18,990,1166,1356,2522
106,12,710,中和區,秀士里,22,1070,1230,1286,2516
106,12,711,三峽區,溪北里,20,873,1329,1182,2511
106,12,712,新店區,文明里,18,1054,1207,1296,2503
106,12,713,三重區,文化里,28,968,1223,1258,2481
106,12,714,中和區,連和里,26,1251,1145,1334,2479
106,12,715,中和區,壽南里,23,951,1253,1213,2466
106,12,716,三重區,錦江里,20,937,1221,1233,2454
106,12,717,新莊區,富國里,14,905,1227,1226,2453
106,12,718,新莊區,立人里,9,898,1190,1259,2449
106,12,719,永和區,復興里,14,1031,1169,1273,2442
106,12,720,板橋區,松柏里,12,955,1216,1207,2423
106,12,721,鶯歌區,西鶯里,18,894,1182,1223,2405
106,12,722,三重區,頂崁里,28,880,1209,1196,2405
106,12,723,板橋區,富貴里,10,865,1154,1241,2395
106,12,724,三重區,慈生里,20,891,1168,1217,2385
106,12,725,汐止區,鄉長里,15,900,1204,1175,2379
106,12,726,三重區,菜寮里,19,908,1145,1228,2373
106,12,727,中和區,錦昌里,13,964,1208,1162,2370
106,12,728,板橋區,民生里,14,918,1102,1264,2366
106,12,729,新莊區,龍福里,13,864,1115,1243,2358
106,12,730,淡水區,水源里,22,891,1258,1098,2356
106,12,731,深坑區,賴仲里,26,1037,1184,1166,2350
106,12,732,三重區,長泰里,20,936,1175,1174,2349
106,12,733,三重區,順德里,23,876,1199,1138,2337
106,12,734,樹林區,北園里,12,769,1210,1122,2332
106,12,735,三重區,福利里,16,1028,1067,1255,2322
106,12,736,永和區,正興里,17,1013,1066,1252,2318
106,12,737,三重區,長安里,22,899,1154,1161,2315
106,12,738,三重區,慈福里,17,955,1182,1133,2315
106,12,739,永和區,新廍里,18,984,1143,1169,2312
106,12,740,貢寮區,真理里,22,721,1106,1202,2308
106,12,741,蘆洲區,仁復里,11,868,1127,1173,2300
106,12,742,泰山區,泰友里,18,795,1123,1176,2299
106,12,743,新莊區,中誠里,15,872,1136,1159,2295
106,12,744,新莊區,文衡里,16,850,1135,1152,2287
106,12,745,新莊區,營盤里,19,909,1165,1120,2285
106,12,746,瑞芳區,龍興里,13,944,1114,1170,2284
106,12,747,瑞芳區,傑魚里,10,809,1168,1104,2272
106,12,748,三重區,慈惠里,15,840,1126,1135,2261
106,12,749,三芝區,後厝里,27,1136,1153,1096,2249
106,12,750,瑞芳區,瑞濱里,13,1084,1098,1137,2235
106,12,751,板橋區,民安里,19,861,1057,1156,2213
106,12,752,板橋區,華福里,13,779,1072,1127,2199
106,12,753,汐止區,樟樹里,14,951,1167,1031,2198
106,12,754,深坑區,昇高里,16,792,1152,1045,2197
106,12,755,中和區,景本里,22,881,1057,1139,2196
106,12,756,三重區,安慶里,16,910,1066,1126,2192
106,12,757,三重區,富福里,20,783,1050,1125,2175
106,12,758,永和區,前溪里,13,983,1008,1164,2172
106,12,759,八里區,頂罟里,13,790,1053,1111,2164
106,12,760,板橋區,新埔里,13,877,1047,1113,2160
106,12,761,樹林區,三龍里,16,762,1102,1056,2158
106,12,762,土城區,土城里,19,840,1036,1118,2154
106,12,763,新店區,張南里,10,1096,961,1190,2151
106,12,764,土城區,長風里,14,816,1047,1103,2150
106,12,765,三重區,錦田里,15,839,1068,1078,2146
106,12,766,三峽區,竹崙里,18,906,1202,936,2138
106,12,767,三重區,長江里,17,903,1057,1075,2132
106,12,768,三重區,萬壽里,20,834,1032,1091,2123
106,12,769,新店區,仁愛里,19,931,975,1126,2101
106,12,770,三重區,永春里,14,800,1030,1068,2098
106,12,771,三重區,光華里,17,896,1018,1055,2073
106,12,772,金山區,磺港里,20,561,1033,1031,2064
106,12,773,三重區,信安里,18,858,994,1066,2060
106,12,774,三重區,正安里,16,853,996,1056,2052
106,12,775,三重區,仁德里,20,861,1043,1008,2051
106,12,776,永和區,上溪里,20,928,946,1104,2050
106,12,777,三重區,大同里,17,927,969,1067,2036
106,12,778,金山區,五湖里,17,619,1007,980,1987
106,12,779,八里區,荖阡里,12,628,1023,958,1981
106,12,780,貢寮區,仁里里,16,678,991,977,1968
106,12,781,三重區,龍門里,20,779,967,999,1966
106,12,782,樹林區,樂山里,15,673,1010,955,1965
106,12,783,瑞芳區,東和里,14,721,973,984,1957
106,12,784,三重區,錦安里,22,790,924,1010,1934
106,12,785,永和區,後溪里,13,855,930,1003,1933
106,12,786,三重區,承德里,20,658,977,951,1928
106,12,787,樹林區,西園里,14,648,1036,892,1928
106,12,788,三重區,正義里,14,767,964,960,1924
106,12,789,新莊區,文明里,16,678,929,990,1919
106,12,790,淡水區,文化里,14,812,896,1019,1915
106,12,791,三重區,中央里,19,857,942,969,1911
106,12,792,瑞芳區,龍川里,11,726,914,994,1908
106,12,793,新莊區,文德里,18,729,926,981,1907
106,12,794,貢寮區,福隆里,22,652,924,970,1894
106,12,795,三重區,自強里,16,751,921,972,1893
106,12,796,瑞芳區,吉慶里,18,720,993,893,1886
106,12,797,板橋區,挹秀里,13,780,904,980,1884
106,12,798,樹林區,東園里,14,686,1009,866,1875
106,12,799,中和區,宜安里,17,823,903,969,1872
106,12,800,烏來區,忠治里,7,530,924,942,1866
106,12,801,新店區,新店里,16,808,914,933,1847
106,12,802,三重區,奕壽里,15,782,912,931,1843
106,12,803,石門區,石門里,14,679,938,902,1840
106,12,804,鶯歌區,同慶里,14,628,885,949,1834
106,12,805,三重區,同慶里,17,732,913,909,1822
106,12,806,三重區,忠孝里,19,747,907,907,1814
106,12,807,三重區,五谷里,25,737,938,866,1804
106,12,808,樹林區,坡內里,15,603,909,888,1797
106,12,809,新店區,文中里,14,801,863,927,1790
106,12,810,永和區,光復里,16,766,817,968,1785
106,12,811,雙溪區,牡丹里,38,718,927,849,1776
106,12,812,石門區,尖鹿里,16,646,917,853,1770
106,12,813,新店區,頂城里,18,715,932,837,1769
106,12,814,八里區,長坑里,14,480,937,828,1765
106,12,815,新店區,龜山里,13,704,895,868,1763
106,12,816,土城區,祖田里,10,611,902,855,1757
106,12,817,八里區,下罟里,12,532,887,868,1755
106,12,818,三重區,大安里,15,676,870,867,1737
106,12,819,汐止區,仁德里,17,754,844,888,1732
106,12,820,淡水區,埤島里,13,736,918,805,1723
106,12,821,土城區,清化里,17,632,908,801,1709
106,12,822,淡水區,興仁里,14,685,906,800,1706
106,12,823,汐止區,保安里,15,648,854,851,1705
106,12,824,林口區,太平里,15,638,844,853,1697
106,12,825,樹林區,圳生里,11,580,875,812,1687
106,12,826,三重區,二重里,15,581,857,827,1684
106,12,827,汐止區,長安里,15,670,851,831,1682
106,12,828,淡水區,賢孝里,14,647,893,780,1673
106,12,829,三峽區,溪南里,16,564,912,740,1652
106,12,830,林口區,湖北里,14,484,871,776,1647
106,12,831,板橋區,留侯里,10,674,775,870,1645
106,12,832,石門區,富基里,15,556,805,824,1629
106,12,833,三重區,長福里,20,640,777,849,1626
106,12,834,新莊區,國泰里,16,575,823,793,1616
106,12,835,淡水區,協元里,10,618,791,798,1589
106,12,836,汐止區,烘內里,21,749,814,774,1588
106,12,837,三重區,光輝里,18,632,790,797,1587
106,12,838,三重區,平和里,18,640,821,763,1584
106,12,839,板橋區,流芳里,10,640,730,837,1567
106,12,840,三重區,開元里,20,673,778,780,1558
106,12,841,三重區,錦通里,16,657,751,800,1551
106,12,842,三峽區,安坑里,16,588,856,687,1543
106,12,843,三重區,重新里,19,611,748,783,1531
106,12,844,淡水區,長庚里,29,643,752,773,1525
106,12,845,五股區,五龍里,17,475,851,663,1514
106,12,846,瑞芳區,龍山里,11,593,812,700,1512
106,12,847,三重區,同安里,19,589,769,740,1509
106,12,848,五股區,觀音里,17,541,834,672,1506
106,12,849,三重區,光榮里,17,653,722,752,1474
106,12,850,瑞芳區,上天里,12,548,797,675,1472
106,12,851,三重區,吉利里,12,628,733,737,1470
106,12,852,林口區,下福里,20,485,766,693,1459
106,12,853,淡水區,坪頂里,10,644,715,742,1457
106,12,854,三重區,秀江里,15,550,714,739,1453
106,12,855,汐止區,義民里,20,645,711,736,1447
106,12,856,淡水區,樹興里,12,671,757,689,1446
106,12,857,坪林區,坪林里,12,476,769,654,1423
106,12,858,瑞芳區,深澳里,15,669,675,743,1418
106,12,859,瑞芳區,龍鎮里,15,573,694,716,1410
106,12,860,三重區,中正里,13,573,711,694,1405
106,12,861,新店區,廣興里,17,591,755,633,1388
106,12,862,板橋區,福翠里,16,564,690,688,1378
106,12,863,金山區,重和里,13,568,705,673,1378
106,12,864,三重區,永興里,17,618,653,709,1362
106,12,865,瑞芳區,海濱里,13,672,626,735,1361
106,12,866,三重區,中民里,17,536,674,680,1354
106,12,867,石門區,德茂里,14,456,717,628,1345
106,12,868,板橋區,歡園里,8,480,692,649,1341
106,12,869,三芝區,興華里,20,537,728,598,1326
106,12,870,三重區,仁義里,17,502,665,658,1323
106,12,871,新店區,直潭里,22,464,697,624,1321
106,12,872,永和區,勵行里,17,575,620,684,1304
106,12,873,萬里區,中幅里,13,368,634,666,1300
106,12,874,瑞芳區,柑坪里,16,442,666,609,1275
106,12,875,坪林區,大林里,10,476,726,547,1273
106,12,876,五股區,更寮里,11,466,659,602,1261
106,12,877,永和區,網溪里,12,507,628,623,1251
106,12,878,三峽區,弘道里,14,428,701,549,1250
106,12,879,三重區,介壽里,13,517,612,634,1246
106,12,880,汐止區,環河里,10,528,669,569,1238
106,12,881,淡水區,忠寮里,13,423,689,545,1234
106,12,882,樹林區,樹東里,16,541,607,617,1224
106,12,883,三峽區,添福里,9,423,658,564,1222
106,12,884,淡水區,清文里,25,500,618,595,1213
106,12,885,林口區,頂福里,20,415,660,551,1211
106,12,886,三重區,正德里,16,507,585,623,1208
106,12,887,淡水區,屯山里,13,365,638,553,1191
106,12,888,雙溪區,泰平里,20,410,597,571,1168
106,12,889,三芝區,古庄里,19,529,597,555,1152
106,12,890,板橋區,黃石里,10,436,568,579,1147
106,12,891,鶯歌區,東鶯里,14,418,571,570,1141
106,12,892,鶯歌區,中鶯里,16,402,553,583,1136
106,12,893,三重區,福星里,17,521,539,594,1133
106,12,894,淡水區,蕃薯里,10,494,626,500,1126
106,12,895,板橋區,復興里,8,318,671,429,1100
106,12,896,貢寮區,和美里,21,351,561,539,1100
106,12,897,林口區,嘉寶里,20,362,581,518,1099
106,12,898,石門區,草里里,12,372,555,531,1086
106,12,899,新店區,塗潭里,11,352,563,511,1074
106,12,900,雙溪區,平林里,14,458,568,506,1074
106,12,901,萬里區,雙興里,15,392,592,480,1072
106,12,902,汐止區,禮門里,17,471,517,550,1067
106,12,903,石碇區,格頭里,13,495,560,507,1067
106,12,904,汐止區,八連里,10,469,569,482,1051
106,12,905,鶯歌區,二甲里,8,339,557,485,1042
106,12,906,永和區,永成里,19,438,507,534,1041
106,12,907,泰山區,大科里,16,340,555,473,1028
106,12,908,三峽區,成福里,16,329,554,463,1017
106,12,909,三重區,谷王里,15,350,532,482,1014
106,12,910,林口區,瑞平里,10,334,540,466,1006
106,12,911,三重區,雙園里,13,415,501,497,998
106,12,912,汐止區,長青里,10,564,461,535,996
106,12,913,永和區,大同里,18,409,500,495,995
106,12,914,石門區,山溪里,16,360,549,442,991
106,12,915,貢寮區,貢寮里,16,393,487,495,982
106,12,916,淡水區,永吉里,22,399,478,498,976
106,12,917,三峽區,五寮里,15,376,520,454,974
106,12,918,貢寮區,福連里,16,312,438,529,967
106,12,919,三芝區,新庄里,12,367,521,445,966
106,12,920,瑞芳區,鼻頭里,11,257,481,484,965
106,12,921,金山區,清泉里,10,298,513,449,962
106,12,922,平溪區,十分里,10,448,519,440,959
106,12,923,新店區,和平里,11,397,479,478,957
106,12,924,淡水區,忠山里,10,363,518,430,948
106,12,925,樹林區,樹北里,18,429,474,473,947
106,12,926,坪林區,粗窟里,11,360,531,397,928
106,12,927,三重區,長生里,10,380,445,465,910
106,12,928,石碇區,永安里,6,390,464,444,908
106,12,929,三芝區,福德里,18,363,455,447,902
106,12,930,坪林區,上德里,13,329,513,387,900
106,12,931,永和區,新生里,18,362,453,426,879
106,12,932,新店區,廣明里,13,425,443,435,878
106,12,933,石碇區,潭邊里,10,404,473,402,875
106,12,934,雙溪區,新基里,17,367,478,391,869
106,12,935,新店區,雙坑里,15,310,479,389,868
106,12,936,永和區,忠義里,16,315,449,418,867
106,12,937,三重區,大德里,11,353,403,453,856
106,12,938,坪林區,漁光里,13,397,460,392,852
106,12,939,石碇區,中民里,14,346,483,350,833
106,12,940,中和區,灰磘里,7,247,444,388,832
106,12,941,板橋區,赤松里,8,324,405,426,831
106,12,942,瑞芳區,龍潭里,13,360,405,426,831
106,12,943,貢寮區,美豐里,21,308,476,344,820
106,12,944,三峽區,有木里,14,372,483,337,820
106,12,945,淡水區,草東里,24,350,416,398,814
106,12,946,烏來區,福山里,6,206,408,396,804
106,12,947,金山區,大同里,9,276,388,415,803
106,12,948,雙溪區,魚行里,29,360,444,341,785
106,12,949,石碇區,隆盛里,12,299,439,343,782
106,12,950,三芝區,錫板里,17,300,451,322,773
106,12,951,淡水區,民安里,24,294,376,396,772
106,12,952,貢寮區,雙玉里,23,308,423,339,762
106,12,953,貢寮區,龍門里,14,253,376,378,754
106,12,954,三峽區,插角里,16,371,439,315,754
106,12,955,萬里區,溪底里,9,297,409,330,739
106,12,956,金山區,六股里,8,234,396,339,735
106,12,957,金山區,三界里,10,215,346,389,735
106,12,958,石門區,茂林里,11,234,382,344,726
106,12,959,石碇區,烏塗里,10,347,411,306,717
106,12,960,三芝區,茂長里,9,300,377,336,713
106,12,961,坪林區,水德里,10,279,377,320,697
106,12,962,平溪區,嶺腳里,10,317,386,310,696
106,12,963,瑞芳區,龍安里,11,276,357,338,695
106,12,964,三峽區,秀川里,10,278,339,355,694
106,12,965,雙溪區,上林里,20,306,392,301,693
106,12,966,石碇區,永定里,10,271,371,316,687
106,12,967,三芝區,店子里,14,261,379,297,676
106,12,968,萬里區,磺潭里,14,234,357,300,657
106,12,969,淡水區,中和里,11,220,370,279,649
106,12,970,金山區,永興里,15,238,347,299,646
106,12,971,深坑區,阿柔里,9,224,357,286,643
106,12,972,汐止區,東山里,20,284,319,300,619
106,12,973,三芝區,圓山里,12,215,356,260,616
106,12,974,鶯歌區,建德里,8,209,337,278,615
106,12,975,烏來區,信賢里,9,203,284,303,587
106,12,976,金山區,豐漁里,9,174,299,281,580
106,12,977,三峽區,金圳里,12,231,337,236,573
106,12,978,金山區,和平里,8,199,263,292,555
106,12,979,三芝區,橫山里,19,227,318,228,546
106,12,980,貢寮區,吉林里,19,241,333,207,540
106,12,981,金山區,萬壽里,8,184,261,278,539
106,12,982,瑞芳區,猴硐里,12,204,295,227,522
106,12,983,瑞芳區,濂洞里,20,255,241,279,520
106,12,984,雙溪區,雙溪里,19,223,254,256,510
106,12,985,瑞芳區,基山里,15,227,253,244,497
106,12,986,平溪區,石底里,10,218,263,225,488
106,12,987,瑞芳區,永慶里,13,242,253,227,480
106,12,988,萬里區,崁脚里,14,178,243,223,466
106,12,989,淡水區,新生里,13,228,219,246,465
106,12,990,金山區,兩湖里,7,140,244,219,463
106,12,991,貢寮區,龍崗里,12,188,260,197,457
106,12,992,坪林區,石石曹里,9,197,244,211,455
106,12,993,雙溪區,外柑里,17,227,267,188,455
106,12,994,平溪區,東勢里,10,239,255,194,449
106,12,995,石碇區,石碇里,9,182,245,198,443
106,12,996,雙溪區,共和里,13,199,233,204,437
106,12,997,石碇區,豐田里,7,222,254,179,433
106,12,998,雙溪區,三港里,17,195,256,176,432
106,12,999,平溪區,薯榔里,10,209,234,193,427
106,12,1000,三重區,德厚里,6,170,194,200,394
106,12,1001,雙溪區,長源里,20,192,222,171,393
106,12,1002,瑞芳區,新山里,11,194,216,174,390
106,12,1003,平溪區,南山里,9,202,225,156,381
106,12,1004,瑞芳區,頌德里,10,188,190,184,374
106,12,1005,瑞芳區,石山里,13,192,195,168,363
106,12,1006,石門區,乾華里,7,148,207,153,360
106,12,1007,中和區,橫路里,7,130,186,171,357
106,12,1008,三芝區,八賢里,10,145,195,156,351
106,12,1009,汐止區,信望里,14,169,182,169,351
106,12,1010,雙溪區,三貂里,20,159,193,154,347
106,12,1011,瑞芳區,崇文里,10,171,182,164,346
106,12,1012,石碇區,彭山里,6,162,187,153,340
106,12,1013,石碇區,豐林里,5,114,170,152,322
106,12,1014,瑞芳區,濂新里,10,134,153,167,320
106,12,1015,三峽區,三峽里,10,125,179,137,316
106,12,1016,瑞芳區,弓橋里,8,138,181,127,308
106,12,1017,瑞芳區,光復里,14,144,163,142,305
106,12,1018,瑞芳區,南雅里,9,92,151,141,292
106,12,1019,石碇區,光明里,5,147,166,110,276
106,12,1020,平溪區,菁桐里,11,128,150,122,272
106,12,1021,平溪區,白石里,13,130,148,119,267
106,12,1022,平溪區,平溪里,10,115,141,126,267
106,12,1023,鶯歌區,東湖里,10,126,150,116,266
106,12,1024,烏來區,孝義里,6,47,138,117,255
106,12,1025,瑞芳區,銅山里,12,109,116,100,216
106,12,1026,金山區,西湖里,7,58,119,85,204
106,12,1027,瑞芳區,瓜山里,11,113,104,93,197
106,12,1028,瑞芳區,福住里,8,102,101,85,186
106,12,1029,平溪區,平湖里,10,94,100,83,183
106,12,1030,平溪區,新寮里,9,99,102,70,172
106,12,1031,瑞芳區,碩仁里,10,74,89,73,162
106,12,1032,平溪區,望古里,8,103,89,69,158
總計,,,,,22343,1543098,1953397,2033292,3986689
