年,月,排名,隸屬區,里,鄰數,戶數,男,女,合計
107,12,1,林口區,湖南里,48,10059,11081,12196,23277
107,12,2,林口區,南勢里,40,9499,9783,10905,20688
107,12,3,三峽區,龍學里,45,6918,7598,8832,16430
107,12,4,樹林區,南園里,52,6568,7571,8205,15776
107,12,5,淡水區,崁頂里,15,7868,7504,8134,15638
107,12,6,板橋區,溪福里,46,5174,7412,7615,15027
107,12,7,蘆洲區,正義里　,25,5337,6952,7580,14532
107,12,8,新店區,公崙里,37,5000,6141,6542,12683
107,12,9,新莊區,西盛里,29,4672,6092,6261,12353
107,12,10,新莊區,立廷里,40,4707,5700,6333,12033
107,12,11,新莊區,雙鳳里,36,4507,5828,6026,11854
107,12,12,新莊區,中原里,33,4569,5547,5950,11497
107,12,13,板橋區,忠翠里,28,4463,5189,5821,11010
107,12,14,新店區,香坡里,46,4766,5316,5651,10967
107,12,15,淡水區,北投里,22,4759,5193,5764,10957
107,12,16,蘆洲區,水湳里　,25,3824,5373,5553,10926
107,12,17,淡水區,竿蓁里,26,5498,4924,5773,10697
107,12,18,三峽區,鳶山里,28,3910,5304,5382,10686
107,12,19,永和區,保順里,38,4407,4944,5697,10641
107,12,20,林口區,西林里,37,4197,5275,5329,10604
107,12,21,板橋區,崑崙里,36,3746,5107,5331,10438
107,12,22,三峽區,龍埔里,36,3742,4988,5141,10129
107,12,23,新莊區,龍鳳里,30,3851,4697,5315,10012
107,12,24,樹林區,柑園里,37,4121,4824,5188,10012
107,12,25,泰山區,全興里,25,3819,4827,5078,9905
107,12,26,蘆洲區,水河里　,18,3442,4880,5000,9880
107,12,27,林口區,麗林里,32,3799,4656,5187,9843
107,12,28,三重區,過田里,28,5206,5336,4363,9699
107,12,29,中和區,平河里,67,3819,4577,4923,9500
107,12,30,新莊區,中平里,23,3493,4402,5069,9471
107,12,31,新店區,柴埕里,34,3665,4529,4841,9370
107,12,32,板橋區,社後里,28,5140,5253,4097,9350
107,12,33,新莊區,中信里,34,3174,4515,4799,9314
107,12,34,板橋區,深丘里,32,3719,4478,4835,9313
107,12,35,新莊區,丹鳳里,28,3516,4478,4719,9197
107,12,36,新店區,張北里,32,4057,4358,4810,9168
107,12,37,淡水區,新春里,15,3651,4363,4717,9080
107,12,38,鶯歌區,永昌里,22,2883,4518,4561,9079
107,12,39,五股區,成泰里,34,3954,4597,4471,9068
107,12,40,泰山區,義仁里,39,3270,4489,4551,9040
107,12,41,板橋區,重慶里,38,3283,4398,4617,9015
107,12,42,土城區,埤林里,38,3181,4314,4618,8932
107,12,43,新莊區,頭前里,16,3862,4331,4528,8859
107,12,44,鶯歌區,二橋里,26,3026,4423,4271,8694
107,12,45,三重區,溪美里,22,3463,4194,4479,8673
107,12,46,土城區,永寧里,37,3203,4319,4344,8663
107,12,47,板橋區,海山里,23,2878,4061,4467,8528
107,12,48,中和區,新南里,49,3586,3943,4569,8512
107,12,49,中和區,積穗里,45,3467,4122,4387,8509
107,12,50,土城區,清水里,32,2952,4137,4338,8475
107,12,51,汐止區,忠孝里,38,3750,3942,4292,8234
107,12,52,鶯歌區,尖山里,16,2957,4142,4072,8214
107,12,53,三重區,碧華里,16,3675,3893,4292,8185
107,12,54,五股區,水碓里,36,2943,4065,4083,8148
107,12,55,淡水區,大庄里,12,4042,3784,4336,8120
107,12,56,板橋區,新翠里,29,3117,3899,4206,8105
107,12,57,蘆洲區,成功里　,29,2641,3870,4153,8023
107,12,58,三峽區,永舘里,25,2838,3827,4168,7995
107,12,59,新店區,安和里,28,3182,3868,4074,7942
107,12,60,新莊區,光華里,28,2724,3900,4021,7921
107,12,61,三峽區,安溪里,38,2801,3892,4009,7901
107,12,62,板橋區,華江里,30,3249,3639,4250,7889
107,12,63,三重區,光明里,30,3044,3819,4056,7875
107,12,64,板橋區,華東里,32,3360,3747,3999,7746
107,12,65,汐止區,中興里,32,3578,3751,3985,7736
107,12,66,淡水區,新興里,8,3278,3570,4121,7691
107,12,67,新店區,五峯里,25,3307,3581,4108,7689
107,12,68,土城區,峯廷里,31,2639,3821,3846,7667
107,12,69,板橋區,德翠里,26,2742,3715,3901,7616
107,12,70,八里區,舊城里,22,2887,3717,3891,7608
107,12,71,中和區,華新里,48,2883,3632,3946,7578
107,12,72,汐止區,厚德里,30,3052,3730,3817,7547
107,12,73,永和區,保安里,34,2966,3566,3946,7512
107,12,74,林口區,仁愛里,30,2895,3542,3940,7482
107,12,75,新莊區,裕民里,32,2640,3705,3771,7476
107,12,76,中和區,外南里,31,4138,4136,3316,7452
107,12,77,新店區,寶福里,29,3206,3584,3836,7420
107,12,78,鶯歌區,建國里,34,2606,3593,3821,7414
107,12,79,板橋區,華德里,32,2988,3536,3862,7398
107,12,80,八里區,龍源里,30,3223,3585,3809,7394
107,12,81,淡水區,民生里,32,3479,3334,4023,7357
107,12,82,三峽區,龍恩里,31,3090,3517,3837,7354
107,12,83,新莊區,後港里,31,2560,3549,3745,7294
107,12,84,蘆洲區,永康里　,22,2465,3489,3789,7278
107,12,85,汐止區,復興里,24,3314,3348,3911,7259
107,12,86,土城區,平和里,34,2457,3547,3679,7226
107,12,87,新莊區,昌平里,21,3338,3354,3859,7213
107,12,88,三芝區,埔坪里,35,2903,3622,3579,7201
107,12,89,中和區,中興里,38,2820,3446,3743,7189
107,12,90,土城區,清溪里,53,2721,3551,3621,7172
107,12,91,泰山區,山腳里,45,2502,3598,3543,7141
107,12,92,三峽區,介壽里,28,2642,3614,3477,7091
107,12,93,板橋區,廣德里,25,2611,3436,3647,7083
107,12,94,板橋區,成和里,22,2657,3483,3598,7081
107,12,95,中和區,員山里,42,2807,3399,3593,6992
107,12,96,淡水區,福德里,19,3419,3320,3637,6957
107,12,97,新莊區,建安里,34,2544,3328,3604,6932
107,12,98,中和區,德行里,42,2829,3323,3577,6900
107,12,99,新莊區,中港里,28,2229,3313,3525,6838
107,12,100,蘆洲區,永樂里　,27,2246,3371,3422,6793
107,12,101,土城區,延和里,32,2483,3210,3534,6744
107,12,102,板橋區,中山里,32,2936,3289,3448,6737
107,12,103,樹林區,保安里,34,2382,3346,3341,6687
107,12,104,三重區,富貴里,32,2845,3158,3500,6658
107,12,105,五股區,成功里,34,2645,3313,3320,6633
107,12,106,中和區,連城里,48,2602,3164,3463,6627
107,12,107,蘆洲區,樓厝里　,24,2452,3224,3395,6619
107,12,108,三重區,田中里,30,2351,3239,3374,6613
107,12,109,板橋區,福安里,25,3001,3134,3405,6539
107,12,110,新店區,新安里,25,3762,3409,3124,6533
107,12,111,中和區,秀景里,43,2873,3181,3352,6533
107,12,112,三重區,成功里,21,2763,3110,3420,6530
107,12,113,深坑區,埔新里,57,2632,3164,3366,6530
107,12,114,新店區,信義里,31,3170,3111,3393,6504
107,12,115,土城區,清和里,28,2235,3252,3244,6496
107,12,116,新店區,德安里,28,2312,3242,3252,6494
107,12,117,汐止區,福安里,16,2445,3093,3361,6454
107,12,118,林口區,東勢里,42,2342,3126,3325,6451
107,12,119,新莊區,立基里,32,2341,3103,3344,6447
107,12,120,三重區,光陽里,33,2593,3190,3254,6444
107,12,121,板橋區,埔墘里,23,2584,3052,3372,6424
107,12,122,蘆洲區,恆德里　,21,2567,3103,3321,6424
107,12,123,新店區,中正里,24,2661,2976,3438,6414
107,12,124,汐止區,湖興里,38,2965,3172,3241,6413
107,12,125,三重區,田安里,42,2400,3095,3315,6410
107,12,126,土城區,金城里,26,2381,3017,3358,6375
107,12,127,淡水區,鄧公里,17,2670,2987,3388,6375
107,12,128,五股區,成州里,27,2287,3242,3132,6374
107,12,129,新莊區,民安里,33,2133,3054,3313,6367
107,12,130,三重區,永豐里,32,2183,3105,3221,6326
107,12,131,中和區,力行里,45,2461,3024,3297,6321
107,12,132,淡水區,竹圍里,15,2976,2838,3480,6318
107,12,133,樹林區,東陽里,31,2251,3177,3132,6309
107,12,134,汐止區,江北里,30,2551,3224,3061,6285
107,12,135,蘆洲區,南港里　,20,2080,3076,3205,6281
107,12,136,新莊區,中美里,24,2261,3013,3236,6249
107,12,137,板橋區,港嘴里,25,2430,3072,3165,6237
107,12,138,土城區,員林里,34,2446,3022,3214,6236
107,12,139,板橋區,溪洲里,21,2199,3035,3200,6235
107,12,140,板橋區,溪頭里,25,2426,3066,3162,6228
107,12,141,板橋區,懷翠里,26,2249,3054,3147,6201
107,12,142,樹林區,彭興里,41,2093,3095,3089,6184
107,12,143,新店區,玫瑰里,28,2338,2958,3225,6183
107,12,144,新莊區,瓊林里,20,2148,3114,3052,6166
107,12,145,蘆洲區,中原里　,29,2191,3026,3136,6162
107,12,146,三重區,永發里,27,2194,3080,3082,6162
107,12,147,新莊區,福興里,17,2184,3107,3054,6161
107,12,148,中和區,中原里,24,2660,2998,3122,6120
107,12,149,蘆洲區,玉清里　,21,2291,2966,3134,6100
107,12,150,中和區,安平里,43,2731,2884,3196,6080
107,12,151,鶯歌區,南鶯里,34,2141,2952,3111,6063
107,12,152,淡水區,水碓里,20,2285,2936,3125,6061
107,12,153,土城區,明德里,30,2417,2796,3263,6059
107,12,154,鶯歌區,中湖里,27,2044,3118,2935,6053
107,12,155,三峽區,礁溪里,37,2246,2964,3083,6047
107,12,156,土城區,日和里,31,2190,2959,3086,6045
107,12,157,新店區,日興里,29,2263,3015,3019,6034
107,12,158,新店區,雙城里,29,2223,3052,2977,6029
107,12,159,樹林區,山佳里,21,1963,3055,2955,6010
107,12,160,土城區,廣福里,33,2102,2926,3052,5978
107,12,161,新店區,新生里,26,2597,2785,3192,5977
107,12,162,汐止區,湖光里,30,2881,2868,3088,5956
107,12,163,新店區,永平里,17,2193,2858,3083,5941
107,12,164,三重區,六福里,29,2010,2938,2990,5928
107,12,165,新店區,中央里,20,2659,2752,3149,5901
107,12,166,林口區,林口里,29,2177,2892,2965,5857
107,12,167,淡水區,八勢里,14,3166,2627,3223,5850
107,12,168,土城區,員仁里,33,2017,2882,2963,5845
107,12,169,中和區,景福里,44,2629,2722,3097,5819
107,12,170,汐止區,新昌里,35,2346,2835,2969,5804
107,12,171,土城區,裕生里,39,2150,2827,2971,5798
107,12,172,三重區,福祉里,20,2329,2775,3017,5792
107,12,173,中和區,錦和里,21,2071,2834,2947,5781
107,12,174,中和區,瓦磘里,29,2277,2758,3019,5777
107,12,175,三重區,永清里,32,2013,2758,2991,5749
107,12,176,汐止區,秀峰里,23,2728,3017,2728,5745
107,12,177,新莊區,信義里,25,2069,2754,2980,5734
107,12,178,蘆洲區,鷺江里　,21,2041,2808,2919,5727
107,12,179,蘆洲區,九芎里　,27,1942,2782,2943,5725
107,12,180,金山區,金美里,35,1949,2714,3002,5716
107,12,181,土城區,員福里,28,2087,2857,2847,5704
107,12,182,蘆洲區,仁德里　,20,1968,2829,2868,5697
107,12,183,新莊區,自立里,26,2215,2696,2987,5683
107,12,184,新莊區,思源里,22,2116,2770,2908,5678
107,12,185,三重區,永福里,30,2012,2736,2934,5670
107,12,186,新莊區,海山里,24,2143,2739,2922,5661
107,12,187,汐止區,自強里,25,2425,2715,2935,5650
107,12,188,板橋區,玉光里,21,2212,2678,2970,5648
107,12,189,淡水區,油車里,20,2368,2727,2899,5626
107,12,190,新店區,安昌里,17,2392,2626,2985,5611
107,12,191,板橋區,純翠里,15,2096,2715,2893,5608
107,12,192,三芝區,埔頭里,42,2207,2753,2851,5604
107,12,193,新店區,江陵里,23,2325,2631,2956,5587
107,12,194,汐止區,北山里,25,2612,2641,2946,5587
107,12,195,樹林區,中山里,25,1910,2836,2744,5580
107,12,196,蘆洲區,仁義里　,18,2722,3018,2537,5555
107,12,197,新店區,青潭里,22,2264,2685,2864,5549
107,12,198,土城區,頂福里,25,2079,2797,2750,5547
107,12,199,板橋區,湳興里,25,2324,2639,2908,5547
107,12,200,土城區,永富里,27,1958,2732,2802,5534
107,12,201,板橋區,聚安里,28,2012,2763,2770,5533
107,12,202,板橋區,華中里,20,1934,2774,2756,5530
107,12,203,五股區,德音里,30,1978,2764,2763,5527
107,12,204,蘆洲區,光華里　,19,1990,2622,2903,5525
107,12,205,三峽區,中正里,34,1773,2765,2753,5518
107,12,206,新店區,寶安里,39,2616,2534,2980,5514
107,12,207,土城區,埤塘里,17,2848,3172,2338,5510
107,12,208,中和區,景平里,43,2476,2595,2907,5502
107,12,209,樹林區,彭福里,33,1974,2735,2767,5502
107,12,210,三重區,五華里,18,2117,2645,2842,5487
107,12,211,三重區,大有里,25,2014,2715,2771,5486
107,12,212,新莊區,南港里,22,1966,2697,2783,5480
107,12,213,汐止區,建成里,23,2383,2534,2937,5471
107,12,214,樹林區,文林里,36,1916,2652,2817,5469
107,12,215,三重區,永順里,36,1903,2629,2839,5468
107,12,216,蘆洲區,仁愛里　,19,1852,2684,2772,5456
107,12,217,樹林區,樹西里,32,2047,2662,2779,5441
107,12,218,中和區,文元里,35,2030,2634,2799,5433
107,12,219,蘆洲區,永安里　,19,1847,2624,2805,5429
107,12,220,新店區,美潭里,20,2157,2620,2785,5405
107,12,221,新店區,寶興里,24,2484,2545,2848,5393
107,12,222,新店區,永安里,25,1996,2616,2749,5365
107,12,223,板橋區,福德里,28,2002,2669,2684,5353
107,12,224,永和區,福和里,23,2325,2520,2830,5350
107,12,225,蘆洲區,長安里　,19,1788,2667,2683,5350
107,12,226,板橋區,自強里,35,2051,2620,2729,5349
107,12,227,中和區,南山里,38,2195,2606,2741,5347
107,12,228,新店區,中興里,18,2320,2510,2819,5329
107,12,229,鶯歌區,大湖里,24,1933,2692,2631,5323
107,12,230,樹林區,彭厝里,40,1747,2633,2686,5319
107,12,231,土城區,樂利里,36,1978,2590,2726,5316
107,12,232,新莊區,成德里,23,1813,2573,2742,5315
107,12,233,新店區,員潭里,19,2253,2605,2707,5312
107,12,234,汐止區,崇德里,29,2117,2614,2694,5308
107,12,235,新莊區,立言里,24,1873,2545,2763,5308
107,12,236,中和區,復興里,55,2082,2484,2819,5303
107,12,237,樹林區,獇寮里,27,1844,2665,2637,5302
107,12,238,永和區,中溪里,21,2099,2619,2655,5274
107,12,239,新莊區,全泰里,27,1948,2576,2694,5270
107,12,240,中和區,內南里,39,1846,2656,2592,5248
107,12,241,中和區,華南里,24,2110,2573,2672,5245
107,12,242,土城區,頂埔里,31,1998,2560,2673,5233
107,12,243,三重區,永德里,34,1900,2547,2684,5231
107,12,244,汐止區,拱北里,31,2135,2646,2580,5226
107,12,245,中和區,民安里,25,1905,2583,2614,5197
107,12,246,汐止區,金龍里,37,2359,2515,2681,5196
107,12,247,泰山區,貴和里,42,1958,2560,2632,5192
107,12,248,中和區,自強里,25,1918,2581,2608,5189
107,12,249,板橋區,龍翠里,20,2010,2517,2665,5182
107,12,250,鶯歌區,永吉里,32,1651,2590,2588,5178
107,12,251,中和區,福祥里,38,2096,2512,2661,5173
107,12,252,中和區,秀明里,56,2407,2381,2779,5160
107,12,253,汐止區,康福里,24,2672,2414,2745,5159
107,12,254,土城區,安和里,28,1837,2537,2614,5151
107,12,255,樹林區,三興里,31,1836,2637,2511,5148
107,12,256,板橋區,民族里,20,1802,2479,2664,5143
107,12,257,蘆洲區,光明里　,23,1793,2526,2617,5143
107,12,258,永和區,秀和里,21,2068,2448,2692,5140
107,12,259,土城區,廷寮里,23,1740,2553,2570,5123
107,12,260,樹林區,東昇里,28,1815,2521,2576,5097
107,12,261,新莊區,光明里,21,1646,2478,2616,5094
107,12,262,土城區,大安里,25,1989,2542,2547,5089
107,12,263,新莊區,立泰里,21,1869,2431,2657,5088
107,12,264,板橋區,福丘里,19,2251,2350,2738,5088
107,12,265,新莊區,中隆里,27,1889,2470,2610,5080
107,12,266,板橋區,江翠里,20,1935,2527,2551,5078
107,12,267,中和區,佳和里,40,2150,2410,2656,5066
107,12,268,土城區,學士里,27,1844,2441,2615,5056
107,12,269,永和區,保平里,25,1982,2406,2643,5049
107,12,270,永和區,和平里,24,2096,2413,2634,5047
107,12,271,新莊區,和平里,21,1781,2478,2557,5035
107,12,272,樹林區,潭底里,33,2083,2760,2274,5034
107,12,273,板橋區,宏翠里,21,2243,2375,2655,5030
107,12,274,永和區,潭安里,20,1998,2418,2611,5029
107,12,275,板橋區,長安里,19,1736,2423,2599,5022
107,12,276,萬里區,萬里里,35,1480,2472,2543,5015
107,12,277,永和區,民樂里,22,1971,2435,2566,5001
107,12,278,泰山區,義學里,25,1750,2493,2493,4986
107,12,279,新莊區,榮和里,25,2919,2937,2032,4969
107,12,280,永和區,永元里,21,1949,2302,2662,4964
107,12,281,新莊區,忠孝里,29,1904,2406,2556,4962
107,12,282,板橋區,港德里,29,1940,2437,2525,4962
107,12,283,八里區,訊塘里,23,2003,2466,2495,4961
107,12,284,中和區,忠孝里,39,1851,2450,2488,4938
107,12,285,永和區,民族里,22,1931,2317,2612,4929
107,12,286,鶯歌區,鳳鳴里,29,1676,2482,2445,4927
107,12,287,永和區,豫溪里,17,2668,2535,2386,4921
107,12,288,淡水區,新民里,12,2010,2355,2565,4920
107,12,289,新莊區,光正里,22,1631,2423,2480,4903
107,12,290,新店區,吉祥里,24,1834,2352,2551,4903
107,12,291,三重區,慈祐里,26,1810,2449,2453,4902
107,12,292,板橋區,明翠里,22,1951,2379,2514,4893
107,12,293,新莊區,四維里,22,1854,2347,2541,4888
107,12,294,五股區,興珍里,40,1704,2523,2364,4887
107,12,295,汐止區,茄苳里,27,1772,2450,2428,4878
107,12,296,淡水區,正德里,14,2095,2211,2658,4869
107,12,297,板橋區,東丘里,20,1671,2370,2496,4866
107,12,298,新莊區,光榮里,20,1556,2378,2487,4865
107,12,299,三重區,福隆里,19,1857,2314,2546,4860
107,12,300,土城區,日新里,27,1770,2397,2462,4859
107,12,301,板橋區,大豐里,22,1784,2337,2492,4829
107,12,302,三重區,幸福里,36,1883,2381,2437,4818
107,12,303,淡水區,學府里,18,2171,2301,2517,4818
107,12,304,新莊區,合鳳里,25,1714,2417,2400,4817
107,12,305,中和區,秀福里,36,1954,2345,2470,4815
107,12,306,中和區,壽德里,31,1841,2277,2528,4805
107,12,307,新店區,中山里,26,2300,2173,2618,4791
107,12,308,三重區,博愛里,22,1661,2349,2441,4790
107,12,309,汐止區,智慧里,24,2223,2219,2569,4788
107,12,310,土城區,沛陂里,21,1865,2440,2348,4788
107,12,311,鶯歌區,鳳祥里,33,1682,2384,2395,4779
107,12,312,中和區,安穗里,19,1840,2306,2466,4772
107,12,313,中和區,景安里,44,1997,2347,2424,4771
107,12,314,新莊區,恆安里,24,1682,2303,2465,4768
107,12,315,新莊區,中和里,30,1699,2347,2420,4767
107,12,316,板橋區,埤墘里,17,1811,2281,2485,4766
107,12,317,土城區,復興里,34,1701,2345,2405,4750
107,12,318,永和區,潭墘里,25,1936,2161,2588,4749
107,12,319,新莊區,全安里,22,1813,2278,2469,4747
107,12,320,新莊區,福基里,17,2052,2332,2402,4734
107,12,321,蘆洲區,永德里　,20,1587,2336,2393,4729
107,12,322,中和區,德穗里,32,1795,2311,2408,4719
107,12,323,永和區,民權里,26,1749,2273,2445,4718
107,12,324,泰山區,楓樹里,28,1722,2367,2343,4710
107,12,325,新莊區,中泰里,22,1774,2330,2376,4706
107,12,326,汐止區,城中里,28,1991,2207,2499,4706
107,12,327,五股區,德泰里,22,1740,2267,2438,4705
107,12,328,汐止區,保長里,22,1994,2345,2355,4700
107,12,329,汐止區,秀山里,26,1845,2301,2382,4683
107,12,330,中和區,秀山里,31,1812,2248,2431,4679
107,12,331,中和區,明穗里,33,1669,2344,2324,4668
107,12,332,中和區,秀峰里,47,2177,2132,2523,4655
107,12,333,汐止區,橫科里,42,2116,2286,2364,4650
107,12,334,樹林區,圳福里,27,1595,2329,2313,4642
107,12,335,土城區,永豐里,27,1651,2257,2381,4638
107,12,336,汐止區,北峰里,26,1881,2355,2282,4637
107,12,337,新莊區,昌隆里,15,1703,2171,2464,4635
107,12,338,土城區,延壽里,27,1707,2312,2316,4628
107,12,339,土城區,員信里,25,1662,2276,2350,4626
107,12,340,五股區,五股里,28,1909,2415,2203,4618
107,12,341,板橋區,新民里,26,1735,2264,2349,4613
107,12,342,板橋區,堂春里,19,1532,2288,2298,4586
107,12,343,中和區,廟美里,40,1788,2239,2343,4582
107,12,344,土城區,貨饒里,22,1799,2252,2328,4580
107,12,345,中和區,和興里,42,1868,2184,2394,4578
107,12,346,樹林區,金寮里,24,1571,2282,2291,4573
107,12,347,金山區,美田里,25,1430,2176,2393,4569
107,12,348,林口區,中湖里,17,1649,2296,2271,4567
107,12,349,鶯歌區,北鶯里,20,1942,2313,2249,4562
107,12,350,中和區,嘉慶里,24,1667,2255,2306,4561
107,12,351,林口區,菁湖里,23,1606,2242,2319,4561
107,12,352,中和區,福美里,35,1726,2221,2337,4558
107,12,353,板橋區,振興里,17,1694,2234,2323,4557
107,12,354,新莊區,幸福里,30,1656,2181,2366,4547
107,12,355,三重區,光田里,27,1938,2208,2326,4534
107,12,356,汐止區,白雲里,26,1864,2268,2263,4531
107,12,357,板橋區,中正里,27,1634,2211,2310,4521
107,12,358,中和區,錦中里,22,1646,2199,2316,4515
107,12,359,汐止區,文化里,21,1845,2177,2337,4514
107,12,360,土城區,延吉里,22,1579,2280,2232,4512
107,12,361,板橋區,新生里,24,1588,2249,2263,4512
107,12,362,中和區,信和里,41,1660,2237,2270,4507
107,12,363,中和區,碧河里,27,1785,2199,2301,4500
107,12,364,新店區,中華里,21,1985,2097,2383,4480
107,12,365,淡水區,民權里,17,2080,2067,2410,4477
107,12,366,新莊區,思賢里,21,1594,2196,2276,4472
107,12,367,中和區,安順里,34,1962,2091,2367,4458
107,12,368,板橋區,莊敬里,17,1641,2135,2316,4451
107,12,369,淡水區,新義里,14,1564,2170,2277,4447
107,12,370,淡水區,沙崙里,8,1920,2163,2279,4442
107,12,371,三重區,民生里,28,1717,2184,2255,4439
107,12,372,中和區,中安里,40,2093,2053,2367,4420
107,12,373,板橋區,雙玉里,18,1601,2122,2296,4418
107,12,374,板橋區,香社里,21,1590,2193,2215,4408
107,12,375,永和區,得和里,25,1842,2060,2346,4406
107,12,376,板橋區,信義里,21,1732,2160,2237,4397
107,12,377,林口區,東林里,27,1534,2226,2169,4395
107,12,378,中和區,東南里,32,1785,2148,2247,4395
107,12,379,三重區,五常里,34,1476,2187,2206,4393
107,12,380,中和區,福南里,29,1574,2097,2296,4393
107,12,381,板橋區,漢生里,22,1672,2132,2259,4391
107,12,382,新店區,新和里,23,1766,2088,2295,4383
107,12,383,土城區,延祿里,21,1569,2180,2202,4382
107,12,384,板橋區,僑中里,16,1531,2168,2203,4371
107,12,385,三重區,永安里,20,1543,2154,2216,4370
107,12,386,中和區,仁和里,42,1558,2161,2208,4369
107,12,387,板橋區,華興里,18,1659,2106,2254,4360
107,12,388,樹林區,樹南里,29,1557,2157,2203,4360
107,12,389,中和區,福善里,42,1847,2054,2297,4351
107,12,390,板橋區,振義里,19,1646,2127,2220,4347
107,12,391,蘆洲區,延平里　,17,1551,2155,2188,4343
107,12,392,樹林區,三多里,21,1468,2199,2143,4342
107,12,393,三重區,仁華里,27,1692,2111,2225,4336
107,12,394,蘆洲區,中路里　,17,1513,2150,2179,4329
107,12,395,泰山區,同榮里,30,1488,2120,2195,4315
107,12,396,林口區,麗園里,19,1538,2136,2178,4314
107,12,397,永和區,店街里,19,1908,1937,2365,4302
107,12,398,板橋區,五權里,19,1576,2162,2139,4301
107,12,399,永和區,永安里,24,1822,1992,2309,4301
107,12,400,中和區,福真里,43,1720,2096,2203,4299
107,12,401,板橋區,柏翠里,18,1794,2050,2249,4299
107,12,402,中和區,崇南里,41,1831,2040,2250,4290
107,12,403,新店區,福民里,25,1863,1997,2289,4286
107,12,404,三峽區,大埔里,22,1449,2270,2015,4285
107,12,405,板橋區,廣福里,12,1555,2084,2198,4282
107,12,406,板橋區,忠誠里,17,1726,2073,2202,4275
107,12,407,永和區,民本里,17,1618,2013,2258,4271
107,12,408,三峽區,八張里,20,1517,2119,2136,4255
107,12,409,樹林區,三福里,32,1522,2096,2158,4254
107,12,410,三重區,田心里,32,1612,2104,2146,4250
107,12,411,永和區,民生里,22,1566,1992,2248,4240
107,12,412,中和區,民生里,30,1754,2024,2206,4230
107,12,413,瑞芳區,爪峯里,14,1594,2072,2139,4211
107,12,414,蘆洲區,信義里　,27,1426,2093,2114,4207
107,12,415,永和區,下溪里,15,1648,2036,2168,4204
107,12,416,淡水區,幸福里,19,1652,2026,2174,4200
107,12,417,中和區,中正里,34,1566,2025,2172,4197
107,12,418,泰山區,同興里,24,1450,2030,2165,4195
107,12,419,板橋區,和平里,16,1670,1982,2206,4188
107,12,420,三重區,五順里,35,1514,2076,2111,4187
107,12,421,新莊區,民有里,20,1555,2004,2183,4187
107,12,422,三重區,福德里,20,1743,1989,2197,4186
107,12,423,樹林區,光興里,21,1439,2100,2083,4183
107,12,424,汐止區,東勢里,22,2046,2046,2135,4181
107,12,425,板橋區,文翠里,19,1585,2032,2139,4171
107,12,426,永和區,水源里,21,1667,1971,2194,4165
107,12,427,淡水區,中興里,18,1726,2013,2152,4165
107,12,428,中和區,嘉新里,22,1472,2062,2102,4164
107,12,429,八里區,埤頭里,28,1600,2082,2080,4162
107,12,430,新莊區,立志里,16,1541,2022,2135,4157
107,12,431,三重區,崇德里,32,1540,2083,2061,4144
107,12,432,板橋區,金華里,23,1472,2016,2116,4132
107,12,433,板橋區,福祿里,19,1604,1932,2194,4126
107,12,434,中和區,明德里,28,1556,2028,2085,4113
107,12,435,五股區,集賢里,22,1427,2040,2062,4102
107,12,436,永和區,秀朗里,23,1580,2000,2098,4098
107,12,437,樹林區,和平里,28,1415,2044,2053,4097
107,12,438,永和區,雙和里,17,1719,1867,2229,4096
107,12,439,泰山區,貴子里,29,1616,2039,2056,4095
107,12,440,板橋區,大安里,24,1511,2061,2023,4084
107,12,441,板橋區,幸福里,19,1501,2015,2049,4064
107,12,442,板橋區,文聖里,17,1445,1974,2079,4053
107,12,443,新店區,福德里,20,1661,1899,2150,4049
107,12,444,新店區,大同里,26,1777,1961,2087,4048
107,12,445,永和區,安和里,18,1743,1860,2186,4046
107,12,446,五股區,集福里,26,1547,2052,1994,4046
107,12,447,中和區,錦盛里,26,1451,1973,2068,4041
107,12,448,三重區,中興里,37,1590,2038,2001,4039
107,12,449,新店區,百忍里,22,1633,1875,2149,4024
107,12,450,蘆洲區,保佑里　,18,1396,2011,2007,4018
107,12,451,中和區,國光里,39,1505,1954,2062,4016
107,12,452,三重區,五福里,17,1651,1913,2096,4009
107,12,453,板橋區,公館里,21,1489,1976,2029,4005
107,12,454,新店區,明德里,27,1751,1889,2111,4000
107,12,455,永和區,秀林里,20,1578,1947,2053,4000
107,12,456,板橋區,浮洲里,25,1416,2002,1992,3994
107,12,457,新店區,小城里,18,1448,1951,2042,3993
107,12,458,板橋區,香丘里,14,1493,1922,2070,3992
107,12,459,新莊區,昌信里,17,1444,1909,2082,3991
107,12,460,新店區,達觀里,21,1982,1844,2145,3989
107,12,461,三重區,清和里,20,1863,1878,2101,3979
107,12,462,五股區,六福里,23,1461,1951,2010,3961
107,12,463,新莊區,富民里,21,1484,1944,2015,3959
107,12,464,三重區,培德里,24,1440,1953,1979,3932
107,12,465,三重區,福樂里,23,1527,1934,1992,3926
107,12,466,樹林區,樹興里,27,1410,1937,1986,3923
107,12,467,板橋區,鄉雲里,21,1645,1867,2054,3921
107,12,468,三重區,六合里,25,1500,1925,1995,3920
107,12,469,板橋區,吉翠里,16,1371,1914,2000,3914
107,12,470,鶯歌區,鳳福里,29,1490,1921,1993,3914
107,12,471,新莊區,民全里,17,1361,1928,1983,3911
107,12,472,新莊區,立功里,25,1417,1896,2003,3899
107,12,473,板橋區,後埔里,17,1580,1920,1969,3889
107,12,474,新莊區,豐年里,16,1372,1907,1981,3888
107,12,475,新莊區,仁義里,20,1438,1955,1927,3882
107,12,476,泰山區,福興里,25,1424,1894,1981,3875
107,12,477,泰山區,貴賢里,27,1523,1897,1975,3872
107,12,478,三重區,厚德里,22,1471,1892,1968,3860
107,12,479,新店區,大豐里,24,1614,1797,2060,3857
107,12,480,永和區,桂林里,18,1533,1846,2010,3856
107,12,481,泰山區,明志里,24,1358,1890,1963,3853
107,12,482,新莊區,萬安里,18,1480,1850,2001,3851
107,12,483,中和區,秀水里,28,1583,1846,1999,3845
107,12,484,板橋區,大觀里,14,1330,1879,1965,3844
107,12,485,新莊區,中宏里,20,1363,1889,1953,3842
107,12,486,永和區,竹林里,30,1556,1811,2015,3826
107,12,487,新莊區,昌明里,18,1315,1856,1970,3826
107,12,488,樹林區,圳安里,23,1368,1935,1888,3823
107,12,489,中和區,枋寮里,35,1530,1871,1938,3809
107,12,490,板橋區,國光里,20,1542,1820,1979,3799
107,12,491,鶯歌區,南靖里,20,1299,1936,1859,3795
107,12,492,三重區,重明里,19,1482,1849,1945,3794
107,12,493,板橋區,華翠里,19,1402,1819,1973,3792
107,12,494,板橋區,聯翠里,17,1657,1800,1989,3789
107,12,495,板橋區,國泰里,15,1444,1793,1992,3785
107,12,496,新莊區,中全里,18,1325,1908,1876,3784
107,12,497,中和區,漳和里,36,1597,1834,1948,3782
107,12,498,樹林區,樹福里,20,1478,1791,1990,3781
107,12,499,中和區,福和里,32,1493,1864,1912,3776
107,12,500,樹林區,樹德里,25,1403,1854,1915,3769
107,12,501,三重區,重陽里,25,1429,1866,1901,3767
107,12,502,板橋區,廣新里,24,1282,1853,1912,3765
107,12,503,泰山區,黎明里,17,1337,1821,1932,3753
107,12,504,三峽區,二鬮里,24,1358,1896,1853,3749
107,12,505,樹林區,大同里,18,1311,1771,1966,3737
107,12,506,板橋區,溪北里,18,1358,1835,1899,3734
107,12,507,板橋區,福星里,20,1357,1781,1934,3715
107,12,508,板橋區,新海里,21,1263,1879,1834,3713
107,12,509,土城區,柑林里,21,1420,1794,1918,3712
107,12,510,板橋區,建國里,31,1436,1784,1922,3706
107,12,511,新莊區,化成里,15,1381,1864,1841,3705
107,12,512,蘆洲區,復興里　,13,1290,1854,1850,3704
107,12,513,八里區,米倉里,24,1467,1890,1813,3703
107,12,514,土城區,學府里,22,1267,1778,1922,3700
107,12,515,萬里區,野柳里,19,1105,1780,1917,3697
107,12,516,汐止區,福山里,18,1740,1714,1978,3692
107,12,517,中和區,安樂里,33,1601,1727,1963,3690
107,12,518,三重區,福民里,19,1367,1813,1873,3686
107,12,519,五股區,五福里,23,1312,1881,1790,3671
107,12,520,新店區,百福里,24,1616,1691,1970,3661
107,12,521,中和區,建和里,34,1409,1781,1880,3661
107,12,522,中和區,正南里,30,1370,1837,1822,3659
107,12,523,永和區,上林里,21,1520,1759,1895,3654
107,12,524,中和區,景新里,32,1467,1739,1908,3647
107,12,525,瑞芳區,新峰里,14,1332,1841,1806,3647
107,12,526,中和區,景文里,29,1561,1743,1902,3645
107,12,527,新莊區,興漢里,32,1398,1792,1844,3636
107,12,528,五股區,民義里,23,1301,1820,1814,3634
107,12,529,樹林區,樹人里,21,1263,1772,1853,3625
107,12,530,土城區,廣興里,18,1321,1734,1889,3623
107,12,531,板橋區,永安里,17,1409,1760,1861,3621
107,12,532,中和區,秀成里,31,1377,1777,1842,3619
107,12,533,新莊區,文聖里,29,1431,1686,1929,3615
107,12,534,三重區,福田里,24,1251,1826,1788,3614
107,12,535,三重區,慈愛里,25,1374,1767,1845,3612
107,12,536,樹林區,中華里,19,1239,1714,1879,3593
107,12,537,中和區,泰安里,42,1447,1696,1894,3590
107,12,538,新店區,明城里,21,1405,1722,1865,3587
107,12,539,中和區,員富里,23,1409,1804,1778,3582
107,12,540,三重區,立德里,22,1314,1732,1833,3565
107,12,541,永和區,永貞里,20,1432,1665,1875,3540
107,12,542,三重區,三民里,15,1295,1741,1797,3538
107,12,543,三重區,永盛里,25,1265,1714,1823,3537
107,12,544,永和區,智光里,32,1389,1679,1853,3532
107,12,545,中和區,秀仁里,23,1479,1701,1825,3526
107,12,546,永和區,福林里,25,1444,1695,1827,3522
107,12,547,板橋區,景星里,24,1521,1658,1858,3516
107,12,548,板橋區,朝陽里,16,1267,1666,1829,3495
107,12,549,泰山區,新明里,25,1236,1728,1766,3494
107,12,550,蘆洲區,樹德里　,14,1271,1750,1743,3493
107,12,551,板橋區,文化里,17,1403,1697,1792,3489
107,12,552,中和區,國華里,22,1318,1716,1770,3486
107,12,553,三重區,龍濱里,20,1272,1694,1782,3476
107,12,554,板橋區,松翠里,18,1376,1684,1791,3475
107,12,555,板橋區,光復里,25,1364,1769,1705,3474
107,12,556,五股區,福德里,19,1308,1731,1737,3468
107,12,557,永和區,河堤里,19,1552,1648,1817,3465
107,12,558,蘆洲區,中華里　,14,1265,1705,1759,3464
107,12,559,蘆洲區,得勝里　,21,1288,1697,1764,3461
107,12,560,深坑區,深坑里,41,1437,1717,1744,3461
107,12,561,中和區,冠穗里,24,1286,1746,1708,3454
107,12,562,新店區,下城里,14,1409,1763,1688,3451
107,12,563,蘆洲區,忠義里　,14,1218,1681,1749,3430
107,12,564,汐止區,忠山里,22,1584,1643,1787,3430
107,12,565,新店區,復興里,21,1465,1624,1797,3421
107,12,566,三重區,富華里,24,1341,1732,1685,3417
107,12,567,瑞芳區,吉安里,16,1297,1721,1696,3417
107,12,568,板橋區,福壽里,16,1288,1679,1736,3415
107,12,569,蘆洲區,福安里　,11,1185,1662,1745,3407
107,12,570,土城區,學成里,18,1167,1688,1713,3401
107,12,571,新店區,國豐里,22,1423,1560,1840,3400
107,12,572,土城區,中正里,18,1263,1620,1769,3389
107,12,573,五股區,成德里,23,1221,1693,1694,3387
107,12,574,板橋區,居仁里,17,1245,1666,1717,3383
107,12,575,新店區,百和里,22,1403,1628,1730,3358
107,12,576,樹林區,東山里,20,1154,1719,1638,3357
107,12,577,八里區,大崁里,17,1239,1728,1621,3349
107,12,578,三重區,仁忠里,23,1275,1661,1676,3337
107,12,579,蘆洲區,溪墘里　,15,1182,1619,1700,3319
107,12,580,三峽區,中埔里,15,1221,1639,1678,3317
107,12,581,板橋區,新興里,17,1518,1576,1738,3314
107,12,582,汐止區,福德里,18,1477,1579,1721,3300
107,12,583,永和區,永興里,26,1324,1556,1744,3300
107,12,584,中和區,清穗里,24,1255,1638,1655,3293
107,12,585,板橋區,仁愛里,20,1183,1613,1673,3286
107,12,586,永和區,河濱里,19,1330,1604,1678,3282
107,12,587,中和區,景南里,34,1334,1560,1718,3278
107,12,588,板橋區,介壽里,17,1261,1553,1711,3264
107,12,589,三峽區,溪東里,16,1060,1689,1567,3256
107,12,590,三重區,尚德里,29,1230,1573,1678,3251
107,12,591,新店區,粗坑里,20,1339,1533,1712,3245
107,12,592,蘆洲區,保新里　,12,1185,1601,1633,3234
107,12,593,土城區,瑞興里,26,1249,1573,1656,3229
107,12,594,新莊區,八德里,16,1201,1564,1664,3228
107,12,595,樹林區,育英里,20,1189,1571,1656,3227
107,12,596,新店區,太平里,20,1419,1537,1686,3223
107,12,597,五股區,貿商里,25,1241,1551,1667,3218
107,12,598,永和區,秀元里,20,1240,1534,1676,3210
107,12,599,板橋區,文德里,12,1181,1573,1634,3207
107,12,600,中和區,興南里,37,1279,1540,1661,3201
107,12,601,永和區,民富里,15,1141,1547,1649,3196
107,12,602,新店區,建國里,18,1342,1498,1697,3195
107,12,603,蘆洲區,得仁里　,15,1162,1553,1639,3192
107,12,604,板橋區,正泰里,16,1120,1511,1673,3184
107,12,605,中和區,安和里,27,1389,1505,1672,3177
107,12,606,土城區,青山里,18,1082,1564,1605,3169
107,12,607,三重區,福安里,25,1275,1556,1607,3163
107,12,608,萬里區,北基里,23,1447,1581,1579,3160
107,12,609,汐止區,興福里,20,1430,1500,1654,3154
107,12,610,永和區,中興里,17,1403,1434,1712,3146
107,12,611,深坑區,土庫里,36,1193,1587,1557,3144
107,12,612,汐止區,橋東里,20,1243,1481,1645,3126
107,12,613,永和區,光明里,17,1325,1408,1715,3123
107,12,614,萬里區,大鵬里,24,1009,1564,1556,3120
107,12,615,土城區,青雲里,21,1102,1510,1604,3114
107,12,616,中和區,吉興里,21,1295,1444,1666,3110
107,12,617,中和區,頂南里,26,1126,1507,1602,3109
107,12,618,三重區,永吉里,20,1195,1514,1587,3101
107,12,619,土城區,頂新里,10,1238,1475,1622,3097
107,12,620,三重區,維德里,21,1163,1516,1571,3087
107,12,621,新莊區,後德里,15,1084,1558,1528,3086
107,12,622,新莊區,民本里,19,1137,1564,1512,3076
107,12,623,板橋區,青翠里,15,1203,1575,1498,3073
107,12,624,板橋區,港尾里,15,1116,1454,1609,3063
107,12,625,板橋區,光仁里,15,1043,1510,1550,3060
107,12,626,新莊區,中華里,15,1223,1512,1546,3058
107,12,627,中和區,正行里,19,1257,1451,1602,3053
107,12,628,板橋區,滿翠里,20,1147,1457,1581,3038
107,12,629,永和區,協和里,22,1307,1461,1571,3032
107,12,630,新莊區,光和里,19,976,1455,1567,3022
107,12,631,汐止區,宜興里,25,1472,1414,1606,3020
107,12,632,板橋區,莒光里,17,1179,1478,1542,3020
107,12,633,永和區,秀成里,17,1192,1474,1537,3011
107,12,634,泰山區,福泰里,25,1050,1521,1477,2998
107,12,635,板橋區,長壽里,11,1071,1483,1496,2979
107,12,636,永和區,民治里,24,1209,1328,1650,2978
107,12,637,板橋區,九如里,16,1082,1425,1537,2962
107,12,638,板橋區,龍安里,20,1081,1438,1521,2959
107,12,639,樹林區,圳民里,16,1111,1570,1386,2956
107,12,640,三重區,大園里,22,1158,1464,1481,2945
107,12,641,汐止區,保新里,13,1410,1441,1503,2944
107,12,642,淡水區,北新里,20,1395,1384,1556,2940
107,12,643,中和區,嘉穗里,15,1030,1447,1472,2919
107,12,644,汐止區,大同里,23,1288,1382,1535,2917
107,12,645,板橋區,仁翠里,16,1100,1414,1495,2909
107,12,646,永和區,文化里,18,1222,1386,1523,2909
107,12,647,中和區,中山里,22,1099,1408,1490,2898
107,12,648,樹林區,太順里,16,946,1475,1422,2897
107,12,649,中和區,民有里,24,1110,1429,1468,2897
107,12,650,板橋區,自立里,20,1090,1408,1489,2897
107,12,651,烏來區,烏來里,15,897,1410,1476,2886
107,12,652,萬里區,龜吼里,20,982,1483,1401,2884
107,12,653,板橋區,西安里,14,1065,1393,1485,2878
107,12,654,永和區,永福里,18,1156,1374,1489,2863
107,12,655,淡水區,義山里,19,1120,1506,1354,2860
107,12,656,三重區,國隆里,26,1134,1382,1476,2858
107,12,657,三重區,中山里,22,1208,1393,1464,2857
107,12,658,板橋區,百壽里,17,1150,1344,1501,2845
107,12,659,新莊區,自強里,15,1155,1433,1407,2840
107,12,660,板橋區,陽明里,17,1054,1381,1447,2828
107,12,661,永和區,秀得里,20,1072,1363,1463,2826
107,12,662,新店區,忠孝里,15,1290,1351,1475,2826
107,12,663,板橋區,光華里,20,1131,1372,1451,2823
107,12,664,蘆洲區,民和里　,15,1054,1406,1416,2822
107,12,665,汐止區,山光里,14,1178,1367,1446,2813
107,12,666,新店區,美城里,14,1078,1352,1444,2796
107,12,667,新莊區,仁愛里,20,1045,1348,1444,2792
107,12,668,新店區,新德里,20,1225,1309,1481,2790
107,12,669,中和區,秀義里,18,1098,1381,1380,2761
107,12,670,深坑區,萬福里,30,1209,1400,1359,2759
107,12,671,永和區,仁愛里,17,1169,1312,1445,2757
107,12,672,三重區,三安里,20,1231,1318,1434,2752
107,12,673,新店區,大鵬里,10,1273,1331,1409,2740
107,12,674,板橋區,民權里,24,1091,1327,1408,2735
107,12,675,板橋區,華貴里,19,1019,1309,1425,2734
107,12,676,新店區,華城里,13,1248,1267,1465,2732
107,12,677,板橋區,東安里,11,913,1351,1372,2723
107,12,678,新莊區,立德里,17,995,1318,1401,2719
107,12,679,蘆洲區,保和里　,15,973,1336,1378,2714
107,12,680,汐止區,湖蓮里,12,1431,1248,1457,2705
107,12,681,永和區,信義里,15,1231,1214,1481,2695
107,12,682,永和區,大新里,16,1216,1225,1460,2685
107,12,683,新莊區,福營里,20,1140,1323,1348,2671
107,12,684,新店區,國校里,10,1124,1303,1355,2658
107,12,685,板橋區,光榮里,20,1015,1319,1321,2640
107,12,686,三重區,永煇里,16,960,1335,1298,2633
107,12,687,板橋區,香雅里,11,1005,1300,1322,2622
107,12,688,三重區,慈化里,17,926,1276,1339,2615
107,12,689,五股區,陸一里,35,1099,1280,1331,2611
107,12,690,新莊區,自信里,12,976,1252,1356,2608
107,12,691,新莊區,祥鳳里,18,916,1294,1309,2603
107,12,692,新店區,長春里,11,1148,1217,1379,2596
107,12,693,新莊區,泰豐里,14,1023,1261,1334,2595
107,12,694,三重區,光正里,22,1292,1255,1321,2576
107,12,695,中和區,民享里,20,935,1258,1311,2569
107,12,696,三重區,長元里,18,1038,1297,1267,2564
107,12,697,蘆洲區,忠孝里　,12,837,1266,1297,2563
107,12,698,深坑區,萬順里,24,1099,1277,1276,2553
107,12,699,板橋區,嵐翠里,12,970,1280,1266,2546
107,12,700,永和區,永樂里,16,1134,1162,1384,2546
107,12,701,新莊區,建福里,13,899,1268,1275,2543
107,12,702,永和區,頂溪里,16,1084,1186,1354,2540
107,12,703,三峽區,溪北里,20,886,1341,1199,2540
107,12,704,中和區,秀士里,22,1088,1246,1294,2540
107,12,705,三重區,瑞德里,19,936,1254,1275,2529
107,12,706,新店區,文明里,18,1070,1216,1310,2526
107,12,707,新店區,忠誠里,20,1112,1223,1302,2525
107,12,708,新莊區,龍安里,15,846,1243,1275,2518
107,12,709,新店區,屈尺里,18,860,1291,1216,2507
107,12,710,石門區,老梅里,19,857,1267,1230,2497
107,12,711,中和區,瑞穗里,18,988,1166,1328,2494
107,12,712,三峽區,嘉添里,21,794,1424,1069,2493
107,12,713,三重區,文化里,28,975,1228,1236,2464
107,12,714,新莊區,富國里,14,903,1218,1239,2457
107,12,715,中和區,連和里,26,1239,1115,1329,2444
107,12,716,三重區,錦江里,20,946,1207,1224,2431
107,12,717,中和區,壽南里,23,943,1223,1196,2419
107,12,718,永和區,復興里,14,1022,1164,1254,2418
107,12,719,新莊區,立人里,9,897,1180,1230,2410
107,12,720,汐止區,鄉長里,15,913,1205,1198,2403
107,12,721,三重區,頂崁里,28,876,1202,1191,2393
107,12,722,三重區,慈生里,20,895,1171,1209,2380
107,12,723,深坑區,賴仲里,26,1048,1198,1171,2369
107,12,724,板橋區,松柏里,12,953,1181,1187,2368
107,12,725,三重區,菜寮里,19,918,1126,1231,2357
107,12,726,三重區,長泰里,20,936,1174,1172,2346
107,12,727,鶯歌區,西鶯里,18,894,1152,1188,2340
107,12,728,板橋區,民生里,14,915,1090,1244,2334
107,12,729,板橋區,富貴里,10,862,1120,1208,2328
107,12,730,中和區,錦昌里,13,955,1176,1149,2325
107,12,731,三重區,福利里,16,1035,1067,1258,2325
107,12,732,新莊區,龍福里,13,865,1099,1219,2318
107,12,733,永和區,正興里,17,999,1071,1241,2312
107,12,734,三重區,長安里,22,902,1152,1160,2312
107,12,735,淡水區,水源里,22,891,1223,1088,2311
107,12,736,樹林區,北園里,12,770,1199,1111,2310
107,12,737,三重區,順德里,23,874,1190,1118,2308
107,12,738,泰山區,泰友里,18,799,1120,1180,2300
107,12,739,新莊區,中誠里,15,879,1118,1169,2287
107,12,740,永和區,新廍里,18,981,1126,1155,2281
107,12,741,新莊區,文衡里,16,867,1121,1158,2279
107,12,742,蘆洲區,仁復里　,11,858,1118,1160,2278
107,12,743,三重區,慈福里,17,944,1158,1115,2273
107,12,744,瑞芳區,龍興里,13,956,1107,1161,2268
107,12,745,三芝區,後厝里,27,1156,1152,1106,2258
107,12,746,瑞芳區,傑魚里,10,798,1163,1089,2252
107,12,747,新莊區,營盤里,19,903,1137,1113,2250
107,12,748,貢寮區,真理里,22,715,1084,1165,2249
107,12,749,中和區,景本里,22,897,1070,1164,2234
107,12,750,瑞芳區,瑞濱里,13,1079,1085,1136,2221
107,12,751,三重區,慈惠里,15,843,1113,1107,2220
107,12,752,樹林區,三龍里,16,777,1136,1084,2220
107,12,753,汐止區,樟樹里,14,960,1178,1037,2215
107,12,754,八里區,頂罟里,13,807,1060,1132,2192
107,12,755,深坑區,昇高里,16,788,1152,1035,2187
107,12,756,板橋區,民安里,19,856,1041,1144,2185
107,12,757,板橋區,華福里,13,779,1059,1120,2179
107,12,758,土城區,土城里,19,849,1053,1123,2176
107,12,759,新店區,張南里,10,1106,955,1220,2175
107,12,760,三重區,富福里,20,797,1035,1139,2174
107,12,761,三重區,安慶里,16,904,1048,1116,2164
107,12,762,永和區,前溪里,13,980,999,1164,2163
107,12,763,板橋區,新埔里,13,891,1039,1111,2150
107,12,764,三重區,錦田里,15,845,1052,1093,2145
107,12,765,三峽區,竹崙里,20,910,1193,930,2123
107,12,766,土城區,長風里,14,808,1025,1089,2114
107,12,767,三重區,長江里,17,899,1042,1065,2107
107,12,768,三重區,光華里,17,931,1013,1085,2098
107,12,769,三重區,仁德里,20,901,1058,1035,2093
107,12,770,新店區,仁愛里,19,931,964,1116,2080
107,12,771,三重區,萬壽里,20,827,1003,1066,2069
107,12,772,三重區,信安里,18,879,994,1061,2055
107,12,773,三重區,大同里,17,934,985,1065,2050
107,12,774,三重區,正安里,16,850,992,1056,2048
107,12,775,三重區,永春里,14,799,993,1040,2033
107,12,776,金山區,磺港里,20,562,1023,1010,2033
107,12,777,永和區,上溪里,20,923,933,1086,2019
107,12,778,樹林區,樂山里,15,683,1035,963,1998
107,12,779,八里區,荖阡里,12,622,1017,942,1959
107,12,780,三重區,龍門里,20,781,967,989,1956
107,12,781,金山區,五湖里,17,618,990,965,1955
107,12,782,永和區,後溪里,13,858,936,1010,1946
107,12,783,貢寮區,仁里里,16,676,967,972,1939
107,12,784,樹林區,西園里,14,657,1025,902,1927
107,12,785,瑞芳區,龍川里,11,733,932,988,1920
107,12,786,新莊區,文德里,18,734,934,985,1919
107,12,787,中和區,宜安里,17,831,924,990,1914
107,12,788,淡水區,文化里,14,811,894,1015,1909
107,12,789,三重區,錦安里,22,783,905,1001,1906
107,12,790,板橋區,挹秀里,13,815,925,979,1904
107,12,791,瑞芳區,東和里,14,715,934,970,1904
107,12,792,三重區,正義里,14,771,953,948,1901
107,12,793,新莊區,文明里,16,675,920,979,1899
107,12,794,瑞芳區,吉慶里,18,720,1008,891,1899
107,12,795,三重區,中央里,19,863,919,979,1898
107,12,796,三重區,忠孝里,19,777,934,947,1881
107,12,797,烏來區,忠治里,7,542,916,961,1877
107,12,798,樹林區,東園里,14,683,1012,859,1871
107,12,799,三重區,自強里,16,751,913,957,1870
107,12,800,三重區,承德里,20,648,954,910,1864
107,12,801,貢寮區,福隆里,22,649,914,938,1852
107,12,802,石門區,石門里,14,685,934,900,1834
107,12,803,新店區,新店里,16,816,901,932,1833
107,12,804,淡水區,埤島里,13,801,975,855,1830
107,12,805,三重區,同慶里,17,727,895,924,1819
107,12,806,三重區,奕壽里,15,773,895,921,1816
107,12,807,鶯歌區,同慶里,14,639,868,935,1803
107,12,808,三重區,五谷里,25,736,926,871,1797
107,12,809,八里區,下罟里,12,544,911,881,1792
107,12,810,八里區,長坑里,14,488,954,832,1786
107,12,811,樹林區,坡內里,15,596,893,887,1780
107,12,812,新店區,頂城里,18,723,930,848,1778
107,12,813,新店區,文中里,14,806,860,917,1777
107,12,814,永和區,光復里,16,766,813,962,1775
107,12,815,汐止區,仁德里,17,782,861,912,1773
107,12,816,石門區,尖鹿里,16,645,917,842,1759
107,12,817,土城區,祖田里,10,610,905,848,1753
107,12,818,三重區,大安里,15,677,872,870,1742
107,12,819,新店區,龜山里,13,700,881,860,1741
107,12,820,林口區,太平里,15,656,859,864,1723
107,12,821,雙溪區,牡丹里,38,717,910,805,1715
107,12,822,汐止區,保安里,15,643,854,860,1714
107,12,823,土城區,清化里,17,623,888,799,1687
107,12,824,淡水區,賢孝里,14,644,897,783,1680
107,12,825,淡水區,興仁里,14,686,886,787,1673
107,12,826,汐止區,長安里,15,676,850,820,1670
107,12,827,三重區,二重里,15,573,843,822,1665
107,12,828,樹林區,圳生里,11,586,853,796,1649
107,12,829,板橋區,留侯里,10,684,785,864,1649
107,12,830,三峽區,溪南里,16,561,902,728,1630
107,12,831,三重區,長福里,20,645,782,836,1618
107,12,832,林口區,湖北里,14,481,862,746,1608
107,12,833,石門區,富基里,15,550,773,821,1594
107,12,834,淡水區,協元里,10,624,784,800,1584
107,12,835,新莊區,國泰里,16,564,800,783,1583
107,12,836,汐止區,烘內里,21,753,820,761,1581
107,12,837,板橋區,流芳里,10,641,732,832,1564
107,12,838,三重區,光輝里,18,632,774,786,1560
107,12,839,三重區,平和里,18,637,800,754,1554
107,12,840,三重區,開元里,20,681,777,775,1552
107,12,841,三重區,錦通里,16,656,739,803,1542
107,12,842,三峽區,安坑里,16,590,852,680,1532
107,12,843,五股區,五龍里,17,479,852,676,1528
107,12,844,三重區,重新里,19,615,740,770,1510
107,12,845,瑞芳區,龍山里,11,597,806,699,1505
107,12,846,淡水區,長庚里,29,644,744,760,1504
107,12,847,三重區,同安里,19,591,764,717,1481
107,12,848,三重區,光榮里,17,656,720,761,1481
107,12,849,五股區,觀音里,17,534,805,674,1479
107,12,850,淡水區,樹興里,12,685,760,713,1473
107,12,851,坪林區,坪林里,12,482,789,681,1470
107,12,852,三重區,吉利里,12,634,722,742,1464
107,12,853,瑞芳區,上天里,12,547,797,661,1458
107,12,854,瑞芳區,深澳里,15,688,685,768,1453
107,12,855,林口區,下福里,20,486,764,682,1446
107,12,856,三重區,中正里,13,577,723,715,1438
107,12,857,汐止區,義民里,20,633,692,722,1414
107,12,858,新店區,廣興里,17,603,763,647,1410
107,12,859,三重區,秀江里,15,542,694,715,1409
107,12,860,淡水區,坪頂里,10,634,694,702,1396
107,12,861,瑞芳區,龍鎮里,15,578,686,710,1396
107,12,862,三重區,永興里,17,630,658,729,1387
107,12,863,板橋區,福翠里,16,558,679,682,1361
107,12,864,瑞芳區,海濱里,13,674,627,722,1349
107,12,865,新店區,直潭里,22,475,709,636,1345
107,12,866,金山區,重和里,13,561,675,652,1327
107,12,867,三重區,中民里,17,529,655,656,1311
107,12,868,三芝區,興華里,20,544,715,593,1308
107,12,869,石門區,德茂里,14,455,696,604,1300
107,12,870,永和區,勵行里,17,578,607,691,1298
107,12,871,板橋區,歡園里,8,468,673,620,1293
107,12,872,三重區,仁義里,17,502,642,647,1289
107,12,873,萬里區,中幅里,13,365,633,654,1287
107,12,874,坪林區,大林里,10,479,722,565,1287
107,12,875,五股區,更寮里,11,461,665,599,1264
107,12,876,汐止區,環河里,10,532,679,572,1251
107,12,877,瑞芳區,柑坪里,16,433,653,594,1247
107,12,878,永和區,網溪里,12,511,619,626,1245
107,12,879,三重區,介壽里,13,514,606,633,1239
107,12,880,三峽區,弘道里,14,420,695,532,1227
107,12,881,三重區,正德里,16,518,599,626,1225
107,12,882,淡水區,清文里,25,510,626,598,1224
107,12,883,淡水區,忠寮里,13,432,689,531,1220
107,12,884,雙溪區,泰平里,20,413,614,594,1208
107,12,885,樹林區,樹東里,16,535,598,598,1196
107,12,886,三峽區,添福里,9,422,631,559,1190
107,12,887,林口區,頂福里,20,412,640,549,1189
107,12,888,三芝區,古庄里,19,557,618,567,1185
107,12,889,淡水區,屯山里,13,367,630,544,1174
107,12,890,鶯歌區,東鶯里,14,430,586,577,1163
107,12,891,板橋區,黃石里,10,435,566,570,1136
107,12,892,鶯歌區,中鶯里,16,404,559,576,1135
107,12,893,三重區,福星里,17,528,520,610,1130
107,12,894,淡水區,蕃薯里,10,495,632,487,1119
107,12,895,板橋區,復興里,8,311,675,428,1103
107,12,896,石門區,草里里,12,379,561,530,1091
107,12,897,石碇區,格頭里,13,511,562,525,1087
107,12,898,貢寮區,和美里,21,349,548,537,1085
107,12,899,林口區,嘉寶里,20,367,581,501,1082
107,12,900,汐止區,禮門里,17,477,519,552,1071
107,12,901,新店區,塗潭里,11,358,565,504,1069
107,12,902,萬里區,雙興里,15,394,594,472,1066
107,12,903,汐止區,八連里,10,471,576,480,1056
107,12,904,雙溪區,平林里,14,448,550,492,1042
107,12,905,鶯歌區,二甲里,8,339,551,475,1026
107,12,906,三峽區,成福里,16,331,551,462,1013
107,12,907,汐止區,長青里,10,568,466,542,1008
107,12,908,三重區,雙園里,13,423,496,505,1001
107,12,909,永和區,永成里,19,432,491,509,1000
107,12,910,林口區,瑞平里,10,334,539,455,994
107,12,911,石門區,山溪里,16,362,548,441,989
107,12,912,樹林區,樹北里,18,447,496,490,986
107,12,913,泰山區,大科里,16,339,531,453,984
107,12,914,永和區,大同里,18,402,496,477,973
107,12,915,新店區,和平里,11,402,471,494,965
107,12,916,淡水區,永吉里,22,400,474,488,962
107,12,917,三重區,谷王里,15,343,508,449,957
107,12,918,三峽區,五寮里,15,374,512,438,950
107,12,919,貢寮區,貢寮里,16,388,472,475,947
107,12,920,貢寮區,福連里,16,308,425,521,946
107,12,921,瑞芳區,鼻頭里,11,261,467,476,943
107,12,922,平溪區,十分里,10,449,507,436,943
107,12,923,金山區,清泉里,10,293,506,434,940
107,12,924,坪林區,粗窟里,11,357,520,402,922
107,12,925,淡水區,忠山里,10,366,507,415,922
107,12,926,石碇區,永安里,6,390,460,456,916
107,12,927,坪林區,上德里,13,331,524,391,915
107,12,928,三重區,長生里,10,385,446,467,913
107,12,929,三芝區,新庄里,12,359,483,427,910
107,12,930,三芝區,福德里,18,364,448,442,890
107,12,931,三重區,大德里,11,360,418,464,882
107,12,932,石碇區,潭邊里,10,409,478,401,879
107,12,933,坪林區,漁光里,13,395,470,403,873
107,12,934,永和區,新生里,18,357,450,420,870
107,12,935,雙溪區,新基里,17,370,471,399,870
107,12,936,新店區,雙坑里,15,310,469,386,855
107,12,937,永和區,忠義里,16,304,431,420,851
107,12,938,新店區,廣明里,13,414,428,421,849
107,12,939,板橋區,赤松里,8,325,404,436,840
107,12,940,石碇區,中民里,14,352,483,352,835
107,12,941,烏來區,福山里,6,210,416,413,829
107,12,942,瑞芳區,龍潭里,13,363,404,420,824
107,12,943,中和區,灰磘里,7,241,445,374,819
107,12,944,貢寮區,美豐里,21,306,470,338,808
107,12,945,金山區,大同里,9,279,385,418,803
107,12,946,淡水區,草東里,24,354,413,384,797
107,12,947,三峽區,有木里,14,367,476,319,795
107,12,948,雙溪區,魚行里,29,360,442,352,794
107,12,949,石碇區,隆盛里,12,299,429,341,770
107,12,950,三芝區,錫板里,17,302,448,322,770
107,12,951,淡水區,民安里,24,296,372,398,770
107,12,952,金山區,六股里,8,239,411,352,763
107,12,953,貢寮區,雙玉里,23,303,417,320,737
107,12,954,貢寮區,龍門里,14,250,361,372,733
107,12,955,萬里區,溪底里,9,294,401,325,726
107,12,956,三峽區,插角里,16,365,423,301,724
107,12,957,金山區,三界里,10,212,337,384,721
107,12,958,三芝區,茂長里,9,304,374,335,709
107,12,959,石碇區,烏塗里,10,346,406,300,706
107,12,960,三峽區,秀川里,10,285,345,359,704
107,12,961,石門區,茂林里,11,233,368,332,700
107,12,962,坪林區,水德里,10,279,368,323,691
107,12,963,平溪區,嶺腳里,10,314,380,308,688
107,12,964,雙溪區,上林里,20,305,390,296,686
107,12,965,瑞芳區,龍安里,11,271,340,337,677
107,12,966,石碇區,永定里,10,273,360,316,676
107,12,967,三芝區,店子里,14,255,371,285,656
107,12,968,萬里區,磺潭里,14,236,355,296,651
107,12,969,金山區,永興里,15,240,343,300,643
107,12,970,汐止區,東山里,20,286,331,303,634
107,12,971,深坑區,阿柔里,9,227,346,285,631
107,12,972,淡水區,中和里,11,218,364,263,627
107,12,973,鶯歌區,建德里,8,209,348,276,624
107,12,974,三芝區,圓山里,12,212,345,253,598
107,12,975,烏來區,信賢里,9,204,283,306,589
107,12,976,金山區,豐漁里,9,170,290,278,568
107,12,977,三峽區,金圳里,12,233,333,231,564
107,12,978,三芝區,橫山里,19,226,317,227,544
107,12,979,貢寮區,吉林里,19,239,337,204,541
107,12,980,金山區,和平里,8,196,258,282,540
107,12,981,金山區,萬壽里,8,184,261,269,530
107,12,982,雙溪區,雙溪里,19,225,263,249,512
107,12,983,瑞芳區,濂洞里,20,253,240,269,509
107,12,984,瑞芳區,猴硐里,12,205,286,219,505
107,12,985,平溪區,石底里,10,220,272,225,497
107,12,986,瑞芳區,永慶里,13,237,254,230,484
107,12,987,瑞芳區,基山里,15,221,244,234,478
107,12,988,貢寮區,龍崗里,12,185,268,196,464
107,12,989,萬里區,崁脚里,14,177,244,218,462
107,12,990,淡水區,新生里,13,232,215,247,462
107,12,991,金山區,兩湖里,7,140,239,217,456
107,12,992,坪林區,石𥕢里,9,198,240,214,454
107,12,993,雙溪區,外柑里,17,224,261,187,448
107,12,994,平溪區,東勢里,10,243,252,194,446
107,12,995,石碇區,石碇里,9,181,237,201,438
107,12,996,石碇區,豐田里,7,218,254,174,428
107,12,997,雙溪區,共和里,13,196,227,197,424
107,12,998,雙溪區,三港里,17,193,245,172,417
107,12,999,平溪區,薯榔里,10,205,229,187,416
107,12,1000,雙溪區,長源里,20,193,220,172,392
107,12,1001,三重區,德厚里,6,166,185,204,389
107,12,1002,瑞芳區,新山里,11,191,214,174,388
107,12,1003,平溪區,南山里,9,199,226,152,378
107,12,1004,瑞芳區,頌德里,10,182,193,178,371
107,12,1005,瑞芳區,石山里,13,182,187,169,356
107,12,1006,雙溪區,三貂里,20,159,195,157,352
107,12,1007,石門區,乾華里,7,147,202,149,351
107,12,1008,中和區,橫路里,7,132,181,168,349
107,12,1009,石碇區,彭山里,6,159,191,157,348
107,12,1010,汐止區,信望里,14,167,183,163,346
107,12,1011,三芝區,八賢里,10,141,193,152,345
107,12,1012,石碇區,豐林里,5,116,184,160,344
107,12,1013,瑞芳區,崇文里,10,169,176,161,337
107,12,1014,瑞芳區,濂新里,10,132,155,175,330
107,12,1015,三峽區,三峽里,10,125,187,135,322
107,12,1016,瑞芳區,弓橋里,8,134,176,128,304
107,12,1017,石碇區,光明里,5,148,176,128,304
107,12,1018,瑞芳區,光復里,14,144,160,134,294
107,12,1019,瑞芳區,南雅里,9,90,154,138,292
107,12,1020,鶯歌區,東湖里,10,128,153,122,275
107,12,1021,平溪區,白石里,13,129,150,123,273
107,12,1022,平溪區,平溪里,10,117,141,124,265
107,12,1023,烏來區,孝義里,6,45,134,123,257
107,12,1024,平溪區,菁桐里,11,125,139,117,256
107,12,1025,金山區,西湖里,7,59,122,88,210
107,12,1026,瑞芳區,銅山里,12,101,114,95,209
107,12,1027,瑞芳區,瓜山里,11,108,97,90,187
107,12,1028,平溪區,平湖里,10,93,99,87,186
107,12,1029,瑞芳區,福住里,8,102,100,83,183
107,12,1030,瑞芳區,碩仁里,10,73,90,74,164
107,12,1031,平溪區,新寮里,9,95,101,63,164
107,12,1032,平溪區,望古里,8,103,87,67,154
總計,,,,,22357,1562037,1954968,2040749,3995717