年,月,排名,隸屬區,里,鄰數,戶數,男,女,合計
108,12,1,林口區,湖南里,48,10714,11886,13015,24901
108,12,2,林口區,南勢里,40,10499,10919,12192,23111
108,12,3,淡水區,崁頂里,15,9101,8653,9377,18030
108,12,4,三峽區,龍學里,45,7041,7754,8975,16729
108,12,5,樹林區,南園里,52,6636,7703,8292,15995
108,12,6,蘆洲區,正義里　,25,5516,7175,7835,15010
108,12,7,板橋區,溪福里,46,5200,7378,7616,14994
108,12,8,新店區,公崙里,37,5286,6407,6831,13238
108,12,9,新莊區,西盛里,29,4855,6278,6468,12746
108,12,10,新莊區,立廷里,40,4838,5857,6550,12407
108,12,11,新莊區,中原里,33,4987,5947,6412,12359
108,12,12,新莊區,雙鳳里,36,4618,5930,6136,12066
108,12,13,林口區,西林里,37,4435,5655,5662,11317
108,12,14,新店區,香坡里,46,4934,5461,5795,11256
108,12,15,淡水區,竿蓁里,26,5819,5146,6070,11216
108,12,16,板橋區,忠翠里,28,4535,5176,5943,11119
108,12,17,淡水區,北投里,22,4851,5265,5850,11115
108,12,18,蘆洲區,水湳里　,25,3844,5345,5568,10913
108,12,19,永和區,保順里,38,4438,4985,5750,10735
108,12,20,三峽區,鳶山里,28,3945,5268,5410,10678
108,12,21,新莊區,龍鳳里,30,4017,4881,5537,10418
108,12,22,板橋區,崑崙里,36,3756,5062,5287,10349
108,12,23,五股區,成泰里,34,4590,5206,5120,10326
108,12,24,三峽區,龍埔里,36,3858,5091,5221,10312
108,12,25,樹林區,柑園里,37,4167,4886,5237,10123
108,12,26,泰山區,全興里,25,3813,4817,5065,9882
108,12,27,蘆洲區,水河里　,18,3460,4832,5027,9859
108,12,28,三重區,過田里,28,5380,5417,4426,9843
108,12,29,林口區,麗林里,32,3809,4652,5172,9824
108,12,30,新莊區,中平里,23,3526,4408,5156,9564
108,12,31,新店區,柴埕里,34,3735,4599,4901,9500
108,12,32,板橋區,社後里,28,5239,5297,4104,9401
108,12,33,板橋區,深丘里,32,3717,4529,4860,9389
108,12,34,新莊區,丹鳳里,28,3569,4564,4817,9381
108,12,35,中和區,平河里,67,3818,4521,4848,9369
108,12,36,新莊區,中信里,34,3191,4510,4775,9285
108,12,37,淡水區,新春里,15,3718,4467,4813,9280
108,12,38,新店區,張北里,32,4127,4396,4867,9263
108,12,39,新莊區,頭前里,16,4007,4486,4710,9196
108,12,40,淡水區,大庄里,12,4555,4264,4926,9190
108,12,41,泰山區,義仁里,39,3302,4504,4601,9105
108,12,42,鶯歌區,永昌里,22,2896,4486,4558,9044
108,12,43,板橋區,重慶里,38,3272,4343,4580,8923
108,12,44,土城區,埤林里,38,3195,4276,4591,8867
108,12,45,三重區,溪美里,31,3540,4217,4523,8740
108,12,46,土城區,永寧里,37,3209,4357,4375,8732
108,12,47,鶯歌區,二橋里,26,3054,4442,4252,8694
108,12,48,鶯歌區,尖山里,16,3194,4342,4319,8661
108,12,49,板橋區,海山里,23,2858,4030,4470,8500
108,12,50,中和區,積穗里,45,3458,4099,4368,8467
108,12,51,三重區,碧華里,16,3755,4041,4421,8462
108,12,52,中和區,新南里,49,3594,3896,4538,8434
108,12,53,土城區,清水里,32,2977,4102,4300,8402
108,12,54,汐止區,忠孝里,38,3825,4028,4340,8368
108,12,55,板橋區,新翠里,29,3230,3932,4294,8226
108,12,56,五股區,水碓里,36,2969,4063,4109,8172
108,12,57,新店區,安和里,28,3277,3949,4163,8112
108,12,58,蘆洲區,成功里　,29,2655,3861,4172,8033
108,12,59,板橋區,華江里,30,3271,3698,4326,8024
108,12,60,三峽區,永舘里,25,2855,3800,4150,7950
108,12,61,板橋區,華東里,32,3441,3808,4091,7899
108,12,62,三峽區,安溪里,38,2822,3878,4004,7882
108,12,63,三重區,光明里,30,3075,3831,4032,7863
108,12,64,淡水區,新興里,8,3328,3626,4235,7861
108,12,65,新店區,五峯里,25,3425,3650,4209,7859
108,12,66,新莊區,光華里,28,2714,3856,3985,7841
108,12,67,汐止區,中興里,32,3634,3807,4032,7839
108,12,68,新莊區,昌平里,21,3565,3637,4172,7809
108,12,69,土城區,峯廷里,31,2667,3835,3890,7725
108,12,70,汐止區,厚德里,30,3103,3788,3858,7646
108,12,71,三峽區,龍恩里,31,3223,3647,3996,7643
108,12,72,板橋區,德翠里,26,2757,3726,3900,7626
108,12,73,八里區,舊城里,22,2936,3727,3871,7598
108,12,74,中和區,華新里,48,2896,3641,3940,7581
108,12,75,中和區,外南里,31,4266,4204,3357,7561
108,12,76,鶯歌區,建國里,34,2676,3630,3888,7518
108,12,77,永和區,保安里,34,2972,3545,3955,7500
108,12,78,林口區,仁愛里,30,2931,3585,3911,7496
108,12,79,八里區,龍源里,30,3242,3620,3848,7468
108,12,80,板橋區,華德里,32,3031,3547,3891,7438
108,12,81,新店區,寶福里,29,3217,3594,3823,7417
108,12,82,新莊區,裕民里,32,2658,3657,3752,7409
108,12,83,淡水區,民生里,32,3513,3339,4058,7397
108,12,84,汐止區,復興里,24,3329,3366,3934,7300
108,12,85,新莊區,後港里,31,2571,3550,3737,7287
108,12,86,板橋區,福安里,25,3288,3453,3819,7272
108,12,87,板橋區,成和里,24,2772,3557,3700,7257
108,12,88,中和區,中興里,38,2830,3476,3765,7241
108,12,89,土城區,平和里,34,2456,3544,3679,7223
108,12,90,蘆洲區,永康里　,22,2462,3467,3726,7193
108,12,91,泰山區,山腳里,45,2541,3614,3565,7179
108,12,92,中和區,員山里,42,2863,3479,3692,7171
108,12,93,三芝區,埔坪里,35,2907,3578,3566,7144
108,12,94,土城區,清溪里,53,2695,3513,3624,7137
108,12,95,林口區,東勢里,42,2591,3466,3650,7116
108,12,96,三峽區,介壽里,28,2715,3643,3471,7114
108,12,97,板橋區,廣德里,25,2634,3452,3653,7105
108,12,98,淡水區,福德里,19,3456,3393,3704,7097
108,12,99,板橋區,中山里,32,3047,3411,3607,7018
108,12,100,新莊區,建安里,34,2551,3336,3590,6926
108,12,101,五股區,成功里,34,2796,3447,3454,6901
108,12,102,汐止區,福安里,16,2692,3311,3578,6889
108,12,103,中和區,德行里,42,2847,3308,3577,6885
108,12,104,土城區,延和里,32,2590,3299,3576,6875
108,12,105,三重區,富貴里,32,2914,3269,3554,6823
108,12,106,新莊區,中港里,28,2242,3320,3482,6802
108,12,107,土城區,員林里,34,2745,3249,3540,6789
108,12,108,蘆洲區,永樂里　,27,2242,3341,3352,6693
108,12,109,中和區,連城里,48,2625,3168,3508,6676
108,12,110,蘆洲區,樓厝里　,24,2455,3223,3427,6650
108,12,111,三重區,田中里,30,2375,3225,3412,6637
108,12,112,新店區,信義里,31,3206,3149,3477,6626
108,12,113,樹林區,保安里,34,2361,3294,3315,6609
108,12,114,中和區,中原里,24,2936,3223,3380,6603
108,12,115,三重區,成功里,21,2790,3133,3441,6574
108,12,116,汐止區,湖興里,38,3009,3230,3336,6566
108,12,117,深坑區,埔新里,57,2634,3156,3373,6529
108,12,118,蘆洲區,恆德里　,21,2580,3113,3379,6492
108,12,119,中和區,秀景里,43,2883,3156,3336,6492
108,12,120,三重區,田安里,42,2431,3124,3357,6481
108,12,121,土城區,清和里,28,2247,3229,3244,6473
108,12,122,三重區,光陽里,33,2629,3195,3258,6453
108,12,123,五股區,成州里,27,2306,3257,3191,6448
108,12,124,新店區,德安里,28,2311,3205,3233,6438
108,12,125,板橋區,埔墘里,23,2595,3052,3378,6430
108,12,126,新店區,新安里,25,3761,3361,3069,6430
108,12,127,土城區,金城里,26,2417,3023,3402,6425
108,12,128,淡水區,鄧公里,17,2683,3002,3398,6400
108,12,129,新莊區,立基里,32,2330,3076,3302,6378
108,12,130,新店區,中正里,24,2669,2934,3431,6365
108,12,131,新莊區,民安里,33,2156,3047,3301,6348
108,12,132,蘆洲區,中原里　,29,2264,3102,3224,6326
108,12,133,三重區,永豐里,32,2195,3070,3233,6303
108,12,134,蘆洲區,南港里　,20,2088,3088,3212,6300
108,12,135,汐止區,江北里,30,2561,3239,3057,6296
108,12,136,淡水區,八勢里,14,3388,2830,3454,6284
108,12,137,淡水區,竹圍里,15,2988,2830,3437,6267
108,12,138,樹林區,東陽里,31,2248,3143,3108,6251
108,12,139,新莊區,中美里,24,2272,3015,3234,6249
108,12,140,板橋區,懷翠里,26,2247,3067,3177,6244
108,12,141,三峽區,礁溪里,37,2370,3034,3194,6228
108,12,142,中和區,力行里,45,2453,2980,3247,6227
108,12,143,板橋區,溪洲里,21,2206,3032,3187,6219
108,12,144,新莊區,瓊林里,20,2158,3129,3048,6177
108,12,145,新店區,玫瑰里,28,2352,2942,3226,6168
108,12,146,板橋區,港嘴里,25,2434,3019,3138,6157
108,12,147,土城區,日和里,31,2252,3008,3146,6154
108,12,148,樹林區,彭興里,41,2110,3071,3072,6143
108,12,149,三重區,永發里,27,2203,3065,3068,6133
108,12,150,板橋區,溪頭里,25,2411,3006,3104,6110
108,12,151,新莊區,福興里,17,2188,3068,3042,6110
108,12,152,蘆洲區,玉清里　,21,2312,2944,3158,6102
108,12,153,中和區,安平里,43,2738,2874,3220,6094
108,12,154,淡水區,水碓里,20,2328,2946,3147,6093
108,12,155,土城區,明德里,30,2439,2824,3267,6091
108,12,156,汐止區,湖光里,30,2928,2893,3180,6073
108,12,157,新店區,日興里,29,2285,3013,3012,6025
108,12,158,三重區,六福里,29,2071,2954,3059,6013
108,12,159,新店區,中央里,20,2705,2820,3191,6011
108,12,160,鶯歌區,南鶯里,34,2148,2922,3079,6001
108,12,161,汐止區,自強里,25,2572,2861,3138,5999
108,12,162,樹林區,山佳里,21,1984,3035,2959,5994
108,12,163,鶯歌區,中湖里,27,2046,3093,2900,5993
108,12,164,新店區,雙城里,29,2217,3020,2943,5963
108,12,165,新店區,新生里,26,2596,2770,3173,5943
108,12,166,新店區,永平里,17,2187,2858,3074,5932
108,12,167,土城區,廣福里,33,2090,2926,2994,5920
108,12,168,汐止區,秀峰里,23,2782,3041,2795,5836
108,12,169,中和區,景福里,44,2655,2731,3087,5818
108,12,170,土城區,員仁里,33,2025,2858,2955,5813
108,12,171,林口區,林口里,29,2191,2855,2954,5809
108,12,172,三重區,福祉里,20,2341,2785,3014,5799
108,12,173,中和區,錦和里,21,2074,2831,2944,5775
108,12,174,中和區,瓦磘里,29,2305,2763,3009,5772
108,12,175,新莊區,信義里,25,2095,2760,2998,5758
108,12,176,土城區,裕生里,39,2161,2806,2951,5757
108,12,177,汐止區,新昌里,35,2354,2792,2950,5742
108,12,178,三重區,永清里,32,2009,2758,2961,5719
108,12,179,蘆洲區,仁德里　,20,1976,2836,2879,5715
108,12,180,蘆洲區,九芎里　,27,1959,2788,2915,5703
108,12,181,金山區,金美里,35,1967,2703,2995,5698
108,12,182,土城區,員福里,28,2081,2835,2856,5691
108,12,183,蘆洲區,鷺江里　,21,2066,2776,2912,5688
108,12,184,淡水區,油車里,20,2398,2773,2910,5683
108,12,185,板橋區,玉光里,21,2243,2685,2967,5652
108,12,186,新莊區,自立里,26,2201,2683,2966,5649
108,12,187,土城區,永富里,27,2069,2785,2860,5645
108,12,188,三重區,永福里,30,2023,2717,2925,5642
108,12,189,汐止區,北山里,25,2626,2641,2989,5630
108,12,190,新店區,安昌里,17,2411,2635,2994,5629
108,12,191,土城區,埤塘里,17,2936,3227,2400,5627
108,12,192,三芝區,埔頭里,42,2233,2771,2844,5615
108,12,193,樹林區,中山里,25,1914,2853,2755,5608
108,12,194,新莊區,思源里,22,2107,2731,2874,5605
108,12,195,板橋區,純翠里,16,2101,2698,2906,5604
108,12,196,新莊區,海山里,24,2148,2712,2886,5598
108,12,197,新店區,江陵里,23,2323,2613,2958,5571
108,12,198,樹林區,彭福里,33,1994,2752,2785,5537
108,12,199,五股區,德音里,30,1990,2757,2780,5537
108,12,200,三重區,大有里,25,2038,2740,2793,5533
108,12,201,蘆洲區,光華里　,19,2005,2635,2895,5530
108,12,202,新店區,青潭里,22,2256,2666,2861,5527
108,12,203,蘆洲區,仁義里　,18,2748,2994,2533,5527
108,12,204,中和區,景平里,43,2501,2583,2943,5526
108,12,205,土城區,頂福里,25,2094,2754,2769,5523
108,12,206,三峽區,中正里,34,1782,2773,2735,5508
108,12,207,板橋區,華中里,20,1940,2763,2740,5503
108,12,208,新店區,寶安里,39,2616,2508,2983,5491
108,12,209,汐止區,建成里,23,2412,2537,2951,5488
108,12,210,蘆洲區,仁愛里　,19,1881,2695,2790,5485
108,12,211,板橋區,聚安里,28,2012,2734,2749,5483
108,12,212,三重區,五華里,18,2125,2638,2833,5471
108,12,213,板橋區,湳興里,25,2302,2606,2864,5470
108,12,214,蘆洲區,永安里　,19,1873,2620,2848,5468
108,12,215,新店區,寶興里,24,2535,2549,2909,5458
108,12,216,樹林區,樹西里,32,2049,2665,2780,5445
108,12,217,新莊區,南港里,22,1977,2663,2760,5423
108,12,218,樹林區,文林里,36,1907,2630,2789,5419
108,12,219,新店區,美潭里,20,2183,2637,2778,5415
108,12,220,三重區,永順里,36,1908,2591,2806,5397
108,12,221,中和區,文元里,35,2028,2620,2763,5383
108,12,222,新莊區,榮和里,25,3174,3150,2225,5375
108,12,223,蘆洲區,長安里　,19,1804,2691,2676,5367
108,12,224,永和區,福和里,23,2315,2516,2834,5350
108,12,225,新店區,永安里,25,2006,2624,2723,5347
108,12,226,汐止區,崇德里,29,2136,2619,2720,5339
108,12,227,板橋區,自強里,35,2055,2613,2717,5330
108,12,228,新店區,員潭里,19,2280,2602,2723,5325
108,12,229,汐止區,拱北里,31,2159,2688,2626,5314
108,12,230,汐止區,金龍里,37,2421,2563,2748,5311
108,12,231,鶯歌區,鳳鳴里,29,1927,2655,2641,5296
108,12,232,中和區,南山里,38,2210,2579,2714,5293
108,12,233,板橋區,福德里,28,2003,2625,2661,5286
108,12,234,新莊區,立言里,24,1877,2514,2769,5283
108,12,235,中和區,復興里,55,2076,2472,2808,5280
108,12,236,鶯歌區,大湖里,24,1930,2668,2605,5273
108,12,237,新店區,中興里,18,2322,2501,2770,5271
108,12,238,新莊區,全泰里,27,1943,2580,2687,5267
108,12,239,土城區,頂埔里,31,2033,2575,2689,5264
108,12,240,板橋區,宏翠里,21,2371,2477,2786,5263
108,12,241,新莊區,中隆里,27,1997,2541,2717,5258
108,12,242,新莊區,成德里,23,1812,2561,2696,5257
108,12,243,土城區,樂利里,36,1963,2548,2697,5245
108,12,244,樹林區,東昇里,28,1918,2604,2639,5243
108,12,245,樹林區,獇寮里,27,1844,2638,2604,5242
108,12,246,中和區,華南里,24,2111,2568,2672,5240
108,12,247,板橋區,福丘里,19,2285,2415,2824,5239
108,12,248,三重區,永德里,34,1919,2548,2691,5239
108,12,249,中和區,民安里,25,1940,2587,2636,5223
108,12,250,鶯歌區,永吉里,32,1666,2622,2586,5208
108,12,251,中和區,自強里,25,1911,2563,2641,5204
108,12,252,永和區,豫溪里,17,2812,2665,2538,5203
108,12,253,中和區,秀明里,56,2405,2392,2806,5198
108,12,254,新莊區,光明里,21,1716,2540,2656,5196
108,12,255,泰山區,貴和里,42,1974,2557,2635,5192
108,12,256,樹林區,彭厝里,40,1723,2572,2619,5191
108,12,257,中和區,福祥里,38,2106,2522,2668,5190
108,12,258,汐止區,康福里,24,2701,2434,2751,5185
108,12,259,蘆洲區,光明里　,23,1810,2538,2641,5179
108,12,260,永和區,中溪里,21,2092,2562,2608,5170
108,12,261,中和區,內南里,39,1851,2618,2551,5169
108,12,262,板橋區,龍翠里,20,2003,2504,2643,5147
108,12,263,板橋區,民族里,20,1809,2501,2640,5141
108,12,264,土城區,安和里,28,1832,2522,2610,5132
108,12,265,土城區,大安里,25,2020,2541,2587,5128
108,12,266,新莊區,立泰里,21,1883,2449,2673,5122
108,12,267,板橋區,江翠里,20,1980,2524,2598,5122
108,12,268,土城區,廷寮里,23,1747,2561,2557,5118
108,12,269,永和區,秀和里,21,2067,2432,2685,5117
108,12,270,樹林區,三興里,31,1837,2615,2478,5093
108,12,271,三重區,慈祐里,26,1879,2518,2574,5092
108,12,272,土城區,學士里,27,1859,2444,2643,5087
108,12,273,永和區,和平里,24,2096,2416,2662,5078
108,12,274,泰山區,義學里,27,1823,2510,2563,5073
108,12,275,樹林區,潭底里,33,2132,2776,2292,5068
108,12,276,中和區,佳和里,40,2172,2374,2656,5030
108,12,277,萬里區,萬里里,35,1495,2472,2542,5014
108,12,278,新莊區,和平里,21,1776,2455,2552,5007
108,12,279,板橋區,長安里,19,1746,2404,2597,5001
108,12,280,永和區,潭安里,20,2011,2394,2606,5000
108,12,281,永和區,民樂里,22,1969,2423,2556,4979
108,12,282,永和區,保平里,25,1990,2384,2586,4970
108,12,283,淡水區,新民里,12,2031,2360,2598,4958
108,12,284,新莊區,忠孝里,29,1923,2409,2545,4954
108,12,285,新莊區,四維里,22,1861,2368,2586,4954
108,12,286,新莊區,福基里,17,2179,2436,2516,4952
108,12,287,板橋區,港德里,29,1945,2410,2531,4941
108,12,288,中和區,忠孝里,39,1872,2429,2490,4919
108,12,289,淡水區,正德里,14,2111,2252,2664,4916
108,12,290,永和區,永元里,21,1935,2293,2623,4916
108,12,291,永和區,民族里,22,1922,2329,2586,4915
108,12,292,新莊區,光正里,22,1627,2406,2489,4895
108,12,293,板橋區,東丘里,20,1693,2368,2519,4887
108,12,294,汐止區,保長里,22,2087,2420,2467,4887
108,12,295,新店區,吉祥里,24,1836,2312,2560,4872
108,12,296,板橋區,明翠里,22,1964,2362,2504,4866
108,12,297,中和區,景安里,44,2048,2366,2488,4854
108,12,298,汐止區,智慧里,24,2269,2244,2607,4851
108,12,299,三重區,福隆里,19,1863,2309,2542,4851
108,12,300,中和區,秀福里,36,1959,2351,2495,4846
108,12,301,八里區,訊塘里,23,1882,2381,2459,4840
108,12,302,板橋區,大豐里,22,1807,2346,2492,4838
108,12,303,土城區,日新里,27,1770,2371,2463,4834
108,12,304,中和區,秀峰里,47,2296,2195,2637,4832
108,12,305,板橋區,埤墘里,17,1843,2299,2531,4830
108,12,306,五股區,興珍里,40,1693,2494,2332,4826
108,12,307,三重區,幸福里,36,1896,2370,2443,4813
108,12,308,土城區,沛陂里,21,1883,2451,2360,4811
108,12,309,汐止區,茄苳里,27,1769,2420,2388,4808
108,12,310,林口區,中湖里,17,1786,2396,2399,4795
108,12,311,淡水區,學府里,18,2188,2277,2516,4793
108,12,312,新莊區,光榮里,20,1553,2334,2449,4783
108,12,313,汐止區,北峰里,26,1981,2406,2372,4778
108,12,314,永和區,潭墘里,25,1952,2175,2594,4769
108,12,315,新莊區,合鳳里,25,1715,2397,2371,4768
108,12,316,中和區,壽德里,31,1844,2267,2497,4764
108,12,317,新莊區,恆安里,24,1691,2295,2466,4761
108,12,318,汐止區,秀山里,26,1896,2349,2402,4751
108,12,319,新莊區,中和里,30,1689,2312,2435,4747
108,12,320,新店區,中山里,26,2298,2154,2593,4747
108,12,321,新莊區,全安里,22,1810,2254,2492,4746
108,12,322,汐止區,城中里,28,2012,2213,2529,4742
108,12,323,新莊區,中泰里,22,1799,2336,2401,4737
108,12,324,泰山區,楓樹里,28,1741,2366,2370,4736
108,12,325,蘆洲區,永德里　,20,1592,2322,2409,4731
108,12,326,中和區,安穗里,19,1847,2294,2434,4728
108,12,327,中和區,明穗里,33,1688,2368,2359,4727
108,12,328,三重區,博愛里,22,1650,2290,2435,4725
108,12,329,中和區,德穗里,32,1814,2291,2431,4722
108,12,330,汐止區,文化里,21,1957,2277,2437,4714
108,12,331,鶯歌區,鳳祥里,33,1686,2352,2352,4704
108,12,332,土城區,復興里,34,1694,2327,2374,4701
108,12,333,永和區,民權里,26,1747,2263,2435,4698
108,12,334,汐止區,橫科里,42,2125,2301,2386,4687
108,12,335,中和區,碧河里,27,1930,2284,2401,4685
108,12,336,五股區,德泰里,22,1748,2269,2405,4674
108,12,337,樹林區,圳福里,27,1610,2333,2335,4668
108,12,338,中和區,秀山里,31,1806,2219,2431,4650
108,12,339,土城區,貨饒里,22,1840,2277,2370,4647
108,12,340,樹林區,金寮里,24,1605,2307,2336,4643
108,12,341,土城區,延壽里,27,1715,2307,2308,4615
108,12,342,板橋區,新民里,26,1740,2249,2361,4610
108,12,343,五股區,五股里,28,1939,2408,2198,4606
108,12,344,土城區,永豐里,27,1649,2232,2355,4587
108,12,345,板橋區,柏翠里,18,2003,2185,2397,4582
108,12,346,新莊區,昌隆里,15,1694,2163,2414,4577
108,12,347,淡水區,沙崙里,8,2008,2235,2341,4576
108,12,348,土城區,員信里,25,1658,2252,2323,4575
108,12,349,中和區,和興里,42,1904,2168,2406,4574
108,12,350,中和區,廟美里,40,1788,2228,2345,4573
108,12,351,板橋區,中正里,27,1676,2239,2333,4572
108,12,352,淡水區,民權里,17,2153,2113,2458,4571
108,12,353,中和區,福美里,35,1750,2219,2348,4567
108,12,354,鶯歌區,北鶯里,20,1960,2309,2257,4566
108,12,355,林口區,菁湖里,23,1620,2243,2319,4562
108,12,356,汐止區,白雲里,26,1875,2276,2278,4554
108,12,357,中和區,嘉慶里,24,1679,2246,2304,4550
108,12,358,板橋區,堂春里,19,1544,2259,2290,4549
108,12,359,板橋區,振興里,17,1703,2221,2308,4529
108,12,360,新店區,中華里,21,2006,2106,2411,4517
108,12,361,板橋區,莊敬里,17,1669,2154,2353,4507
108,12,362,金山區,美田里,25,1437,2140,2365,4505
108,12,363,板橋區,新生里,24,1608,2223,2279,4502
108,12,364,土城區,延吉里,22,1590,2258,2236,4494
108,12,365,新莊區,幸福里,30,1650,2161,2329,4490
108,12,366,中和區,信和里,41,1658,2212,2274,4486
108,12,367,新莊區,思賢里,21,1608,2187,2289,4476
108,12,368,中和區,安順里,34,1966,2105,2365,4470
108,12,369,三重區,光田里,27,1933,2182,2286,4468
108,12,370,三重區,民生里,28,1724,2199,2255,4454
108,12,371,中和區,錦中里,22,1652,2167,2287,4454
108,12,372,板橋區,信義里,21,1747,2189,2264,4453
108,12,373,板橋區,雙玉里,18,1609,2116,2321,4437
108,12,374,淡水區,新義里,14,1561,2153,2282,4435
108,12,375,三重區,仁華里,27,1715,2143,2286,4429
108,12,376,土城區,延祿里,21,1579,2191,2211,4402
108,12,377,中和區,福善里,42,1865,2066,2333,4399
108,12,378,中和區,崇南里,41,1889,2085,2313,4398
108,12,379,中和區,東南里,32,1788,2141,2255,4396
108,12,380,永和區,得和里,25,1849,2051,2343,4394
108,12,381,板橋區,漢生里,22,1691,2127,2263,4390
108,12,382,中和區,中安里,40,2073,2016,2374,4390
108,12,383,板橋區,忠誠里,17,1757,2100,2276,4376
108,12,384,板橋區,華興里,18,1702,2129,2247,4376
108,12,385,板橋區,香社里,21,1598,2177,2194,4371
108,12,386,汐止區,東勢里,22,2132,2144,2227,4371
108,12,387,林口區,麗園里,19,1554,2126,2239,4365
108,12,388,新店區,新和里,23,1767,2082,2279,4361
108,12,389,三重區,五常里,34,1473,2168,2192,4360
108,12,390,板橋區,僑中里,16,1535,2171,2185,4356
108,12,391,泰山區,同榮里,30,1491,2116,2236,4352
108,12,392,中和區,福南里,29,1587,2083,2265,4348
108,12,393,板橋區,振義里,19,1669,2127,2202,4329
108,12,394,蘆洲區,中路里　,17,1523,2150,2174,4324
108,12,395,蘆洲區,延平里　,17,1558,2151,2168,4319
108,12,396,樹林區,樹南里,29,1558,2139,2179,4318
108,12,397,永和區,店街里,19,1905,1948,2366,4314
108,12,398,樹林區,三多里,21,1477,2174,2137,4311
108,12,399,三重區,永安里,20,1527,2123,2186,4309
108,12,400,中和區,仁和里,42,1539,2120,2185,4305
108,12,401,新店區,福民里,25,1887,2001,2303,4304
108,12,402,三峽區,大埔里,22,1475,2279,2023,4302
108,12,403,永和區,永安里,24,1820,1984,2313,4297
108,12,404,林口區,東林里,27,1524,2188,2105,4293
108,12,405,三峽區,八張里,20,1548,2124,2166,4290
108,12,406,三重區,福德里,20,1783,2043,2237,4280
108,12,407,永和區,民本里,17,1615,2010,2268,4278
108,12,408,板橋區,廣福里,12,1565,2070,2196,4266
108,12,409,中和區,民生里,30,1774,2037,2215,4252
108,12,410,樹林區,三福里,32,1551,2093,2157,4250
108,12,411,八里區,埤頭里,28,1640,2112,2130,4242
108,12,412,板橋區,五權里,19,1573,2107,2123,4230
108,12,413,淡水區,中興里,18,1771,2038,2191,4229
108,12,414,板橋區,和平里,16,1687,1989,2237,4226
108,12,415,蘆洲區,信義里　,27,1453,2080,2142,4222
108,12,416,中和區,福真里,43,1726,2058,2161,4219
108,12,417,永和區,民生里,22,1552,1971,2236,4207
108,12,418,樹林區,光興里,21,1443,2114,2092,4206
108,12,419,永和區,下溪里,15,1674,2042,2155,4197
108,12,420,三重區,田心里,32,1614,2075,2113,4188
108,12,421,板橋區,文翠里,19,1605,2039,2133,4172
108,12,422,新莊區,民有里,20,1551,1970,2201,4171
108,12,423,永和區,水源里,21,1660,1964,2201,4165
108,12,424,板橋區,金華里,23,1483,2039,2119,4158
108,12,425,中和區,明德里,28,1563,2055,2102,4157
108,12,426,三重區,五順里,35,1514,2055,2100,4155
108,12,427,新莊區,立志里,16,1550,2026,2127,4153
108,12,428,瑞芳區,爪峯里,14,1592,2042,2110,4152
108,12,429,泰山區,同興里,24,1446,2004,2141,4145
108,12,430,五股區,集賢里,22,1464,2070,2075,4145
108,12,431,中和區,嘉新里,22,1470,2051,2086,4137
108,12,432,泰山區,貴子里,29,1638,2052,2080,4132
108,12,433,中和區,中正里,34,1561,1974,2155,4129
108,12,434,淡水區,幸福里,19,1637,1983,2130,4113
108,12,435,永和區,秀林里,20,1615,1988,2114,4102
108,12,436,板橋區,福祿里,19,1614,1924,2175,4099
108,12,437,三重區,崇德里,32,1552,2058,2034,4092
108,12,438,板橋區,大安里,24,1529,2074,2018,4092
108,12,439,永和區,雙和里,17,1733,1860,2228,4088
108,12,440,新店區,達觀里,21,2017,1890,2189,4079
108,12,441,三重區,中興里,37,1622,2050,2022,4072
108,12,442,三重區,五福里,17,1669,1958,2113,4071
108,12,443,永和區,秀朗里,23,1594,1983,2081,4064
108,12,444,五股區,集福里,26,1544,2036,2017,4053
108,12,445,板橋區,文聖里,17,1447,1968,2083,4051
108,12,446,三重區,清和里,20,1887,1916,2129,4045
108,12,447,板橋區,浮洲里,25,1480,2032,2001,4033
108,12,448,樹林區,和平里,28,1411,1995,2035,4030
108,12,449,新店區,明德里,27,1800,1904,2126,4030
108,12,450,板橋區,香丘里,14,1520,1930,2097,4027
108,12,451,中和區,錦盛里,26,1467,1970,2056,4026
108,12,452,板橋區,幸福里,19,1502,1992,2031,4023
108,12,453,新店區,福德里,20,1657,1869,2143,4012
108,12,454,新店區,百忍里,22,1645,1853,2155,4008
108,12,455,新莊區,昌信里,17,1474,1936,2064,4000
108,12,456,新店區,大同里,26,1770,1930,2063,3993
108,12,457,中和區,國光里,39,1506,1941,2050,3991
108,12,458,永和區,安和里,18,1744,1821,2159,3980
108,12,459,板橋區,公館里,21,1477,1948,2009,3957
108,12,460,五股區,六福里,23,1477,1944,2008,3952
108,12,461,新莊區,富民里,21,1489,1936,2011,3947
108,12,462,板橋區,鄉雲里,21,1674,1882,2060,3942
108,12,463,蘆洲區,保佑里　,18,1402,1964,1977,3941
108,12,464,新店區,小城里,18,1450,1918,2017,3935
108,12,465,三重區,六合里,25,1535,1959,1968,3927
108,12,466,中和區,枋寮里,35,1588,1898,2011,3909
108,12,467,三重區,培德里,24,1444,1930,1975,3905
108,12,468,三重區,重明里,19,1554,1899,2001,3900
108,12,469,三重區,福樂里,23,1541,1912,1987,3899
108,12,470,永和區,桂林里,18,1549,1879,2016,3895
108,12,471,鶯歌區,鳳福里,29,1500,1915,1974,3889
108,12,472,泰山區,貴賢里,27,1520,1883,2005,3888
108,12,473,新莊區,豐年里,16,1373,1900,1987,3887
108,12,474,中和區,漳和里,36,1681,1878,2004,3882
108,12,475,新莊區,民全里,17,1359,1914,1967,3881
108,12,476,板橋區,吉翠里,16,1380,1885,1987,3872
108,12,477,板橋區,後埔里,17,1584,1903,1960,3863
108,12,478,樹林區,樹興里,27,1411,1895,1968,3863
108,12,479,新莊區,萬安里,18,1481,1855,2007,3862
108,12,480,板橋區,大觀里,14,1345,1891,1966,3857
108,12,481,新店區,大豐里,24,1618,1793,2062,3855
108,12,482,中和區,秀水里,28,1583,1838,2015,3853
108,12,483,樹林區,圳安里,23,1374,1926,1923,3849
108,12,484,新莊區,立功里,25,1410,1857,1986,3843
108,12,485,泰山區,福興里,25,1423,1885,1956,3841
108,12,486,新莊區,化成里,15,1482,1929,1906,3835
108,12,487,板橋區,國泰里,15,1468,1822,2007,3829
108,12,488,板橋區,聯翠里,17,1681,1802,2021,3823
108,12,489,新莊區,昌明里,18,1330,1842,1976,3818
108,12,490,泰山區,明志里,24,1358,1881,1932,3813
108,12,491,永和區,竹林里,30,1547,1825,1983,3808
108,12,492,新莊區,仁義里,20,1432,1912,1894,3806
108,12,493,新店區,百福里,24,1660,1744,2054,3798
108,12,494,中和區,景文里,29,1614,1800,1997,3797
108,12,495,新莊區,中宏里,20,1367,1867,1927,3794
108,12,496,三重區,厚德里,22,1465,1853,1937,3790
108,12,497,板橋區,國光里,20,1545,1820,1969,3789
108,12,498,板橋區,廣新里,24,1303,1852,1933,3785
108,12,499,樹林區,樹福里,20,1477,1797,1978,3775
108,12,500,板橋區,居仁里,17,1437,1855,1913,3768
108,12,501,三峽區,二鬮里,24,1361,1907,1861,3768
108,12,502,樹林區,樹德里,25,1406,1844,1922,3766
108,12,503,泰山區,黎明里,17,1339,1846,1920,3766
108,12,504,鶯歌區,南靖里,20,1289,1914,1846,3760
108,12,505,八里區,米倉里,24,1502,1921,1829,3750
108,12,506,汐止區,福山里,18,1753,1749,1987,3736
108,12,507,五股區,民義里,23,1350,1865,1869,3734
108,12,508,板橋區,華翠里,19,1393,1786,1946,3732
108,12,509,土城區,柑林里,21,1409,1796,1933,3729
108,12,510,中和區,福和里,32,1495,1846,1880,3726
108,12,511,樹林區,大同里,18,1319,1771,1952,3723
108,12,512,板橋區,溪北里,18,1354,1831,1890,3721
108,12,513,三重區,重陽里,25,1426,1839,1876,3715
108,12,514,土城區,學府里,22,1265,1778,1935,3713
108,12,515,新莊區,中全里,18,1319,1873,1835,3708
108,12,516,板橋區,新海里,21,1271,1863,1837,3700
108,12,517,中和區,安樂里,33,1605,1721,1978,3699
108,12,518,板橋區,福星里,20,1361,1765,1933,3698
108,12,519,三重區,福民里,19,1358,1812,1868,3680
108,12,520,蘆洲區,復興里　,13,1299,1842,1830,3672
108,12,521,五股區,五福里,23,1304,1866,1776,3642
108,12,522,土城區,廣興里,18,1337,1735,1905,3640
108,12,523,板橋區,建國里,31,1429,1753,1881,3634
108,12,524,萬里區,野柳里,19,1103,1731,1901,3632
108,12,525,瑞芳區,新峰里,14,1344,1816,1814,3630
108,12,526,中和區,正南里,30,1373,1840,1790,3630
108,12,527,中和區,秀成里,31,1382,1785,1844,3629
108,12,528,中和區,員富里,23,1446,1827,1800,3627
108,12,529,樹林區,中華里,19,1247,1732,1893,3625
108,12,530,中和區,建和里,34,1418,1756,1867,3623
108,12,531,中和區,景新里,32,1477,1713,1906,3619
108,12,532,新店區,明城里,21,1406,1741,1874,3615
108,12,533,永和區,上林里,21,1506,1740,1867,3607
108,12,534,樹林區,樹人里,21,1268,1743,1860,3603
108,12,535,八里區,大崁里,17,1380,1850,1750,3600
108,12,536,板橋區,永安里,17,1415,1758,1841,3599
108,12,537,新莊區,文聖里,29,1422,1663,1929,3592
108,12,538,中和區,泰安里,42,1457,1700,1888,3588
108,12,539,板橋區,景星里,24,1537,1709,1869,3578
108,12,540,蘆洲區,保新里　,12,1322,1754,1822,3576
108,12,541,三重區,立德里,22,1328,1746,1827,3573
108,12,542,三重區,三民里,15,1300,1760,1807,3567
108,12,543,三重區,福田里,24,1251,1803,1760,3563
108,12,544,三重區,慈愛里,25,1368,1745,1816,3561
108,12,545,新莊區,興漢里,32,1371,1745,1813,3558
108,12,546,三重區,永盛里,25,1281,1702,1830,3532
108,12,547,板橋區,文化里,17,1412,1712,1819,3531
108,12,548,五股區,福德里,19,1362,1764,1767,3531
108,12,549,中和區,秀仁里,23,1490,1690,1831,3521
108,12,550,永和區,永貞里,20,1437,1662,1858,3520
108,12,551,永和區,河堤里,19,1578,1669,1843,3512
108,12,552,深坑區,深坑里,41,1462,1728,1782,3510
108,12,553,永和區,智光里,32,1393,1671,1834,3505
108,12,554,板橋區,朝陽里,16,1272,1675,1821,3496
108,12,555,永和區,福林里,25,1439,1682,1800,3482
108,12,556,五股區,成德里,23,1260,1754,1718,3472
108,12,557,板橋區,松翠里,18,1408,1665,1805,3470
108,12,558,板橋區,光復里,25,1379,1771,1692,3463
108,12,559,三重區,富華里,24,1359,1740,1722,3462
108,12,560,新店區,下城里,14,1418,1770,1691,3461
108,12,561,泰山區,新明里,25,1219,1711,1744,3455
108,12,562,三重區,龍濱里,20,1272,1689,1759,3448
108,12,563,中和區,國華里,22,1318,1700,1743,3443
108,12,564,蘆洲區,得勝里　,21,1292,1691,1751,3442
108,12,565,蘆洲區,樹德里　,14,1270,1723,1716,3439
108,12,566,汐止區,忠山里,22,1591,1658,1773,3431
108,12,567,蘆洲區,忠義里　,14,1228,1668,1753,3421
108,12,568,中和區,冠穗里,24,1286,1711,1702,3413
108,12,569,板橋區,福壽里,16,1297,1677,1736,3413
108,12,570,蘆洲區,中華里　,14,1261,1660,1747,3407
108,12,571,土城區,中正里,18,1266,1610,1790,3400
108,12,572,三峽區,中埔里,15,1258,1673,1723,3396
108,12,573,新店區,復興里,21,1470,1603,1785,3388
108,12,574,蘆洲區,福安里　,11,1190,1666,1717,3383
108,12,575,土城區,學成里,18,1170,1676,1702,3378
108,12,576,瑞芳區,吉安里,16,1286,1707,1660,3367
108,12,577,三重區,仁忠里,23,1275,1647,1697,3344
108,12,578,新店區,百和里,22,1408,1609,1728,3337
108,12,579,樹林區,東山里,20,1152,1696,1623,3319
108,12,580,新店區,國豐里,22,1398,1504,1810,3314
108,12,581,板橋區,新興里,17,1552,1587,1721,3308
108,12,582,汐止區,福德里,18,1470,1594,1713,3307
108,12,583,永和區,永興里,26,1329,1574,1731,3305
108,12,584,蘆洲區,溪墘里　,15,1203,1612,1692,3304
108,12,585,中和區,景南里,34,1337,1562,1724,3286
108,12,586,永和區,河濱里,19,1321,1594,1674,3268
108,12,587,板橋區,介壽里,17,1279,1555,1707,3262
108,12,588,樹林區,育英里,20,1220,1599,1659,3258
108,12,589,汐止區,橋東里,20,1320,1552,1701,3253
108,12,590,中和區,清穗里,24,1267,1601,1647,3248
108,12,591,板橋區,仁愛里,20,1180,1607,1636,3243
108,12,592,三峽區,溪東里,16,1069,1669,1564,3233
108,12,593,新莊區,八德里,16,1208,1564,1661,3225
108,12,594,新店區,太平里,20,1436,1515,1710,3225
108,12,595,中和區,安和里,27,1398,1522,1689,3211
108,12,596,新店區,建國里,18,1345,1479,1715,3194
108,12,597,中和區,興南里,37,1281,1536,1658,3194
108,12,598,三重區,尚德里,29,1222,1531,1662,3193
108,12,599,五股區,貿商里,25,1252,1532,1658,3190
108,12,600,土城區,瑞興里,26,1237,1546,1640,3186
108,12,601,永和區,中興里,17,1409,1449,1733,3182
108,12,602,土城區,青山里,18,1091,1574,1604,3178
108,12,603,永和區,秀元里,20,1227,1511,1666,3177
108,12,604,板橋區,文德里,12,1179,1562,1615,3177
108,12,605,新店區,粗坑里,20,1347,1509,1666,3175
108,12,606,汐止區,興福里,20,1443,1502,1671,3173
108,12,607,深坑區,土庫里,36,1208,1598,1571,3169
108,12,608,永和區,民富里,15,1131,1515,1635,3150
108,12,609,土城區,頂新里,10,1252,1497,1652,3149
108,12,610,蘆洲區,得仁里　,15,1158,1527,1621,3148
108,12,611,板橋區,正泰里,16,1118,1476,1649,3125
108,12,612,新莊區,後德里,15,1094,1575,1546,3121
108,12,613,土城區,青雲里,21,1118,1521,1598,3119
108,12,614,永和區,光明里,17,1327,1397,1719,3116
108,12,615,萬里區,北基里,23,1444,1545,1561,3106
108,12,616,三重區,福安里,25,1245,1518,1582,3100
108,12,617,新莊區,民本里,19,1151,1556,1526,3082
108,12,618,三重區,永吉里,20,1190,1480,1598,3078
108,12,619,萬里區,大鵬里,24,1020,1544,1533,3077
108,12,620,中和區,吉興里,21,1294,1396,1679,3075
108,12,621,板橋區,青翠里,15,1211,1574,1488,3062
108,12,622,永和區,協和里,22,1316,1472,1587,3059
108,12,623,板橋區,光仁里,15,1047,1497,1561,3058
108,12,624,新莊區,中華里,15,1231,1511,1546,3057
108,12,625,中和區,正行里,19,1262,1444,1612,3056
108,12,626,中和區,頂南里,26,1109,1489,1560,3049
108,12,627,板橋區,港尾里,15,1113,1438,1584,3022
108,12,628,板橋區,滿翠里,20,1140,1456,1556,3012
108,12,629,三重區,維德里,21,1157,1482,1526,3008
108,12,630,板橋區,莒光里,17,1183,1472,1534,3006
108,12,631,永和區,民治里,24,1229,1344,1660,3004
108,12,632,新莊區,光和里,19,981,1458,1546,3004
108,12,633,永和區,秀成里,17,1180,1462,1529,2991
108,12,634,汐止區,宜興里,25,1461,1396,1592,2988
108,12,635,板橋區,長壽里,11,1086,1476,1502,2978
108,12,636,泰山區,福泰里,25,1050,1500,1472,2972
108,12,637,樹林區,圳民里,16,1110,1569,1402,2971
108,12,638,汐止區,保新里,13,1426,1448,1517,2965
108,12,639,板橋區,百壽里,17,1205,1372,1590,2962
108,12,640,板橋區,九如里,16,1090,1415,1533,2948
108,12,641,三重區,大園里,22,1155,1462,1471,2933
108,12,642,板橋區,仁翠里,16,1100,1416,1512,2928
108,12,643,汐止區,大同里,23,1282,1373,1554,2927
108,12,644,板橋區,龍安里,20,1083,1422,1505,2927
108,12,645,淡水區,北新里,20,1397,1396,1530,2926
108,12,646,中和區,嘉穗里,15,1046,1459,1462,2921
108,12,647,板橋區,西安里,14,1066,1406,1498,2904
108,12,648,烏來區,烏來里,15,900,1411,1482,2893
108,12,649,樹林區,太順里,16,940,1479,1412,2891
108,12,650,中和區,民有里,24,1115,1420,1464,2884
108,12,651,板橋區,自立里,20,1098,1381,1501,2882
108,12,652,萬里區,龜吼里,20,993,1480,1397,2877
108,12,653,永和區,文化里,18,1228,1366,1509,2875
108,12,654,汐止區,山光里,14,1220,1399,1472,2871
108,12,655,中和區,中山里,22,1087,1370,1483,2853
108,12,656,三重區,中山里,22,1217,1388,1464,2852
108,12,657,永和區,永福里,18,1159,1361,1490,2851
108,12,658,新店區,華城里,13,1287,1318,1518,2836
108,12,659,新店區,新德里,20,1277,1324,1499,2823
108,12,660,板橋區,光華里,20,1142,1368,1447,2815
108,12,661,永和區,秀得里,20,1076,1341,1468,2809
108,12,662,三重區,國隆里,26,1130,1357,1442,2799
108,12,663,蘆洲區,民和里　,15,1043,1391,1406,2797
108,12,664,淡水區,義山里,19,1112,1479,1312,2791
108,12,665,新莊區,自強里,15,1151,1408,1380,2788
108,12,666,深坑區,萬福里,30,1232,1409,1377,2786
108,12,667,新店區,美城里,14,1087,1342,1444,2786
108,12,668,板橋區,陽明里,17,1046,1360,1425,2785
108,12,669,新店區,忠孝里,15,1294,1331,1452,2783
108,12,670,汐止區,湖蓮里,12,1462,1291,1489,2780
108,12,671,新莊區,仁愛里,20,1052,1344,1434,2778
108,12,672,永和區,仁愛里,17,1181,1332,1435,2767
108,12,673,中和區,秀義里,18,1104,1382,1384,2766
108,12,674,三重區,三安里,20,1240,1318,1438,2756
108,12,675,新莊區,立德里,17,1005,1329,1417,2746
108,12,676,新店區,大鵬里,10,1278,1311,1419,2730
108,12,677,板橋區,民權里,24,1091,1312,1405,2717
108,12,678,蘆洲區,保和里　,15,974,1334,1377,2711
108,12,679,永和區,大新里,16,1218,1216,1479,2695
108,12,680,永和區,信義里,15,1228,1206,1485,2691
108,12,681,板橋區,華貴里,19,1006,1277,1410,2687
108,12,682,板橋區,東安里,11,900,1323,1360,2683
108,12,683,板橋區,光榮里,20,1030,1346,1311,2657
108,12,684,三重區,永煇里,16,981,1348,1291,2639
108,12,685,新莊區,福營里,20,1141,1310,1320,2630
108,12,686,五股區,陸一里,35,1108,1296,1332,2628
108,12,687,板橋區,香雅里,11,1005,1283,1332,2615
108,12,688,新店區,國校里,10,1126,1282,1333,2615
108,12,689,三重區,慈化里,17,932,1269,1335,2604
108,12,690,新店區,長春里,11,1146,1225,1379,2604
108,12,691,新莊區,自信里,12,974,1254,1349,2603
108,12,692,新莊區,泰豐里,14,1031,1256,1346,2602
108,12,693,三重區,光正里,22,1307,1272,1319,2591
108,12,694,新莊區,祥鳳里,18,922,1278,1290,2568
108,12,695,永和區,頂溪里,16,1104,1195,1370,2565
108,12,696,中和區,民享里,20,933,1253,1312,2565
108,12,697,深坑區,萬順里,24,1102,1287,1276,2563
108,12,698,蘆洲區,忠孝里　,12,850,1246,1314,2560
108,12,699,三重區,長元里,18,1046,1295,1254,2549
108,12,700,新店區,文明里,18,1077,1217,1332,2549
108,12,701,板橋區,嵐翠里,12,972,1271,1271,2542
108,12,702,三重區,瑞德里,19,944,1266,1271,2537
108,12,703,中和區,秀士里,22,1080,1227,1310,2537
108,12,704,新莊區,建福里,13,906,1261,1270,2531
108,12,705,新店區,忠誠里,20,1110,1224,1294,2518
108,12,706,新店區,屈尺里,18,891,1274,1232,2506
108,12,707,三峽區,溪北里,20,887,1302,1192,2494
108,12,708,中和區,瑞穗里,18,994,1167,1326,2493
108,12,709,永和區,永樂里,16,1117,1115,1370,2485
108,12,710,中和區,連和里,26,1248,1115,1364,2479
108,12,711,新莊區,龍安里,15,851,1219,1240,2459
108,12,712,八里區,頂罟里,13,997,1226,1230,2456
108,12,713,中和區,壽南里,23,952,1221,1213,2434
108,12,714,三峽區,嘉添里,21,787,1382,1044,2426
108,12,715,永和區,復興里,14,1025,1175,1249,2424
108,12,716,石門區,老梅里,19,851,1240,1184,2424
108,12,717,三重區,錦江里,20,937,1198,1216,2414
108,12,718,新莊區,富國里,14,901,1194,1203,2397
108,12,719,三重區,文化里,28,960,1191,1195,2386
108,12,720,深坑區,賴仲里,26,1053,1201,1180,2381
108,12,721,汐止區,鄉長里,15,910,1179,1192,2371
108,12,722,三重區,福利里,16,1042,1085,1277,2362
108,12,723,三重區,頂崁里,28,875,1182,1166,2348
108,12,724,三重區,菜寮里,19,920,1116,1230,2346
108,12,725,三重區,慈生里,20,892,1155,1188,2343
108,12,726,中和區,錦昌里,13,972,1183,1159,2342
108,12,727,板橋區,民生里,14,917,1113,1223,2336
108,12,728,三重區,順德里,23,889,1192,1138,2330
108,12,729,板橋區,富貴里,10,870,1126,1201,2327
108,12,730,三重區,長泰里,20,948,1166,1151,2317
108,12,731,三重區,慈惠里,15,912,1153,1163,2316
108,12,732,新莊區,龍福里,13,862,1101,1214,2315
108,12,733,樹林區,北園里,12,773,1208,1107,2315
108,12,734,三重區,長安里,22,912,1135,1169,2304
108,12,735,永和區,新廍里,18,1006,1131,1170,2301
108,12,736,板橋區,松柏里,12,935,1127,1173,2300
108,12,737,鶯歌區,西鶯里,18,882,1133,1167,2300
108,12,738,永和區,正興里,17,1006,1069,1228,2297
108,12,739,三重區,慈福里,17,955,1177,1120,2297
108,12,740,新莊區,中誠里,15,874,1132,1163,2295
108,12,741,淡水區,水源里,22,879,1205,1065,2270
108,12,742,新莊區,文衡里,16,872,1113,1151,2264
108,12,743,蘆洲區,仁復里　,11,863,1106,1147,2253
108,12,744,泰山區,泰友里,18,798,1104,1144,2248
108,12,745,三芝區,後厝里,27,1154,1138,1097,2235
108,12,746,新莊區,營盤里,19,908,1118,1114,2232
108,12,747,貢寮區,真理里,22,719,1090,1140,2230
108,12,748,瑞芳區,龍興里,13,946,1086,1141,2227
108,12,749,瑞芳區,傑魚里,10,796,1153,1055,2208
108,12,750,瑞芳區,瑞濱里,13,1078,1082,1124,2206
108,12,751,板橋區,民安里,19,863,1039,1160,2199
108,12,752,永和區,前溪里,13,992,1017,1176,2193
108,12,753,中和區,景本里,22,895,1054,1139,2193
108,12,754,三重區,光華里,17,991,1040,1148,2188
108,12,755,土城區,土城里,19,879,1056,1130,2186
108,12,756,新店區,張南里,10,1103,962,1214,2176
108,12,757,汐止區,樟樹里,14,943,1144,1029,2173
108,12,758,新莊區,立人里,9,824,1070,1102,2172
108,12,759,深坑區,昇高里,16,788,1128,1033,2161
108,12,760,三重區,錦田里,15,863,1074,1086,2160
108,12,761,三重區,富福里,20,789,1025,1128,2153
108,12,762,樹林區,三龍里,16,776,1106,1044,2150
108,12,763,板橋區,新埔里,13,886,1036,1103,2139
108,12,764,板橋區,華福里,13,774,1038,1087,2125
108,12,765,三重區,長江里,17,904,1037,1085,2122
108,12,766,土城區,長風里,14,812,1026,1089,2115
108,12,767,三重區,安慶里,16,887,1002,1110,2112
108,12,768,三峽區,竹崙里,20,912,1187,925,2112
108,12,769,三重區,信安里,18,906,1015,1093,2108
108,12,770,樹林區,樂山里,15,722,1068,1021,2089
108,12,771,新店區,仁愛里,19,954,958,1115,2073
108,12,772,三重區,正安里,16,856,987,1069,2056
108,12,773,三重區,仁德里,20,894,1019,1025,2044
108,12,774,三重區,大同里,17,936,984,1060,2044
108,12,775,三重區,萬壽里,20,818,974,1066,2040
108,12,776,三重區,永春里,14,808,982,1045,2027
108,12,777,永和區,上溪里,20,922,932,1072,2004
108,12,778,板橋區,挹秀里,13,862,962,1019,1981
108,12,779,金山區,磺港里,20,563,998,975,1973
108,12,780,三重區,龍門里,20,793,961,994,1955
108,12,781,八里區,荖阡里,12,630,1017,937,1954
108,12,782,永和區,後溪里,13,863,951,998,1949
108,12,783,新莊區,文德里,18,742,943,978,1921
108,12,784,金山區,五湖里,17,618,971,942,1913
108,12,785,樹林區,西園里,14,661,1023,890,1913
108,12,786,三重區,錦安里,22,787,906,1004,1910
108,12,787,中和區,宜安里,17,836,919,987,1906
108,12,788,瑞芳區,龍川里,11,739,923,981,1904
108,12,789,三重區,五谷里,25,803,984,913,1897
108,12,790,貢寮區,仁里里,16,675,947,947,1894
108,12,791,三重區,正義里,14,767,955,939,1894
108,12,792,三重區,忠孝里,19,782,924,960,1884
108,12,793,瑞芳區,吉慶里,18,720,998,886,1884
108,12,794,新莊區,文明里,16,674,918,961,1879
108,12,795,三重區,中央里,19,854,915,963,1878
108,12,796,瑞芳區,東和里,14,713,925,951,1876
108,12,797,三重區,承德里,20,656,952,917,1869
108,12,798,烏來區,忠治里,7,553,908,957,1865
108,12,799,淡水區,文化里,14,813,862,999,1861
108,12,800,三重區,自強里,16,765,909,948,1857
108,12,801,三重區,同慶里,17,743,901,950,1851
108,12,802,新店區,新店里,16,827,903,935,1838
108,12,803,淡水區,埤島里,13,816,984,852,1836
108,12,804,八里區,長坑里,14,499,964,848,1812
108,12,805,八里區,下罟里,12,557,910,901,1811
108,12,806,石門區,石門里,14,688,923,887,1810
108,12,807,樹林區,東園里,14,673,971,833,1804
108,12,808,汐止區,仁德里,17,819,881,923,1804
108,12,809,新店區,文中里,14,815,871,926,1797
108,12,810,三重區,奕壽里,15,783,882,910,1792
108,12,811,貢寮區,福隆里,22,646,880,911,1791
108,12,812,樹林區,坡內里,15,603,908,880,1788
108,12,813,新店區,頂城里,18,721,929,844,1773
108,12,814,新店區,龜山里,13,709,893,879,1772
108,12,815,永和區,光復里,16,749,802,954,1756
108,12,816,鶯歌區,同慶里,14,639,851,901,1752
108,12,817,三重區,大安里,15,679,866,879,1745
108,12,818,林口區,太平里,15,657,863,881,1744
108,12,819,土城區,祖田里,10,609,898,837,1735
108,12,820,石門區,尖鹿里,16,639,900,805,1705
108,12,821,汐止區,保安里,15,648,851,843,1694
108,12,822,淡水區,賢孝里,14,652,897,781,1678
108,12,823,雙溪區,牡丹里,38,713,875,786,1661
108,12,824,板橋區,留侯里,10,686,798,862,1660
108,12,825,土城區,清化里,17,622,880,779,1659
108,12,826,汐止區,長安里,15,670,824,835,1659
108,12,827,淡水區,興仁里,14,683,886,771,1657
108,12,828,三重區,二重里,15,575,826,822,1648
108,12,829,樹林區,圳生里,11,580,850,788,1638
108,12,830,林口區,湖北里,14,491,878,751,1629
108,12,831,汐止區,烘內里,21,767,839,759,1598
108,12,832,三重區,長福里,20,643,776,822,1598
108,12,833,三峽區,溪南里,16,561,892,698,1590
108,12,834,淡水區,協元里,10,622,773,790,1563
108,12,835,新莊區,國泰里,16,555,779,774,1553
108,12,836,三重區,平和里,18,635,792,758,1550
108,12,837,三重區,光輝里,18,631,764,785,1549
108,12,838,板橋區,流芳里,10,635,720,826,1546
108,12,839,三重區,開元里,20,695,774,771,1545
108,12,840,石門區,富基里,15,549,747,791,1538
108,12,841,三重區,錦通里,16,652,737,794,1531
108,12,842,瑞芳區,龍山里,11,596,803,704,1507
108,12,843,三重區,同安里,19,603,772,735,1507
108,12,844,坪林區,坪林里,12,488,802,701,1503
108,12,845,三峽區,安坑里,16,590,835,666,1501
108,12,846,淡水區,長庚里,29,650,737,763,1500
108,12,847,三重區,重新里,19,615,734,763,1497
108,12,848,三重區,光榮里,17,666,722,767,1489
108,12,849,淡水區,樹興里,12,713,754,726,1480
108,12,850,瑞芳區,上天里,12,557,798,674,1472
108,12,851,五股區,五龍里,17,479,819,649,1468
108,12,852,瑞芳區,深澳里,15,688,690,765,1455
108,12,853,五股區,觀音里,17,532,792,659,1451
108,12,854,三重區,吉利里,12,632,709,734,1443
108,12,855,三重區,中正里,13,585,716,725,1441
108,12,856,林口區,下福里,20,486,740,696,1436
108,12,857,新店區,廣興里,17,612,775,646,1421
108,12,858,淡水區,坪頂里,10,629,690,694,1384
108,12,859,汐止區,義民里,20,622,674,709,1383
108,12,860,三重區,永興里,17,628,650,724,1374
108,12,861,三重區,秀江里,15,530,681,690,1371
108,12,862,瑞芳區,海濱里,13,684,633,717,1350
108,12,863,板橋區,福翠里,16,560,676,673,1349
108,12,864,瑞芳區,龍鎮里,15,572,662,682,1344
108,12,865,新店區,直潭里,22,481,713,617,1330
108,12,866,三重區,中民里,17,524,668,649,1317
108,12,867,三芝區,興華里,20,547,708,592,1300
108,12,868,坪林區,大林里,10,483,719,572,1291
108,12,869,金山區,重和里,13,556,647,641,1288
108,12,870,石門區,德茂里,14,452,687,597,1284
108,12,871,三重區,仁義里,17,508,632,650,1282
108,12,872,板橋區,歡園里,8,472,663,616,1279
108,12,873,萬里區,中幅里,13,371,632,646,1278
108,12,874,永和區,勵行里,17,585,596,681,1277
108,12,875,三重區,介壽里,13,516,609,645,1254
108,12,876,汐止區,環河里,10,534,678,572,1250
108,12,877,雙溪區,泰平里,20,418,636,613,1249
108,12,878,五股區,更寮里,11,447,658,586,1244
108,12,879,板橋區,黃石里,10,493,605,633,1238
108,12,880,樹林區,樹東里,16,551,595,641,1236
108,12,881,瑞芳區,柑坪里,16,436,643,590,1233
108,12,882,三重區,正德里,16,522,596,626,1222
108,12,883,淡水區,忠寮里,13,436,691,530,1221
108,12,884,永和區,網溪里,12,497,597,622,1219
108,12,885,淡水區,清文里,25,501,616,590,1206
108,12,886,三峽區,弘道里,14,415,683,520,1203
108,12,887,三芝區,古庄里,19,580,626,576,1202
108,12,888,三重區,福星里,17,570,552,638,1190
108,12,889,三峽區,添福里,9,422,623,551,1174
108,12,890,林口區,頂福里,20,410,626,539,1165
108,12,891,淡水區,屯山里,13,362,622,531,1153
108,12,892,鶯歌區,東鶯里,14,428,576,570,1146
108,12,893,鶯歌區,中鶯里,16,407,559,581,1140
108,12,894,淡水區,蕃薯里,10,494,628,475,1103
108,12,895,汐止區,禮門里,17,503,540,562,1102
108,12,896,石碇區,格頭里,13,523,565,523,1088
108,12,897,貢寮區,和美里,21,353,555,522,1077
108,12,898,石門區,草里里,12,378,552,524,1076
108,12,899,新店區,塗潭里,11,358,567,505,1072
108,12,900,林口區,嘉寶里,20,374,576,491,1067
108,12,901,萬里區,雙興里,15,392,584,475,1059
108,12,902,板橋區,復興里,8,290,629,405,1034
108,12,903,汐止區,八連里,10,462,559,465,1024
108,12,904,鶯歌區,二甲里,8,343,547,469,1016
108,12,905,三峽區,成福里,16,333,542,464,1006
108,12,906,雙溪區,平林里,14,443,540,463,1003
108,12,907,三重區,雙園里,13,417,495,504,999
108,12,908,永和區,永成里,19,429,486,512,998
108,12,909,汐止區,長青里,10,562,456,523,979
108,12,910,石門區,山溪里,16,361,542,431,973
108,12,911,泰山區,大科里,16,337,524,448,972
108,12,912,三重區,谷王里,15,351,505,462,967
108,12,913,樹林區,樹北里,18,434,479,484,963
108,12,914,新店區,和平里,11,400,468,486,954
108,12,915,林口區,瑞平里,10,332,518,434,952
108,12,916,板橋區,赤松里,8,393,449,491,940
108,12,917,坪林區,粗窟里,11,362,524,415,939
108,12,918,貢寮區,貢寮里,16,386,467,471,938
108,12,919,淡水區,永吉里,22,403,453,482,935
108,12,920,瑞芳區,鼻頭里,11,262,464,468,932
108,12,921,貢寮區,福連里,16,304,421,508,929
108,12,922,石碇區,永安里,6,402,466,463,929
108,12,923,金山區,清泉里,10,293,498,426,924
108,12,924,三重區,長生里,10,389,448,472,920
108,12,925,淡水區,忠山里,10,360,504,412,916
108,12,926,三峽區,五寮里,15,369,497,418,915
108,12,927,坪林區,上德里,13,334,516,394,910
108,12,928,平溪區,十分里,10,438,492,412,904
108,12,929,坪林區,漁光里,13,396,485,417,902
108,12,930,三重區,大德里,11,364,416,466,882
108,12,931,三芝區,新庄里,12,353,459,412,871
108,12,932,三芝區,福德里,18,356,438,428,866
108,12,933,石碇區,潭邊里,10,408,467,397,864
108,12,934,新店區,廣明里,13,416,418,433,851
108,12,935,新店區,雙坑里,15,310,463,375,838
108,12,936,雙溪區,新基里,17,363,453,384,837
108,12,937,永和區,忠義里,16,301,422,415,837
108,12,938,中和區,灰磘里,7,251,457,375,832
108,12,939,烏來區,福山里,6,212,411,419,830
108,12,940,瑞芳區,龍潭里,13,366,401,417,818
108,12,941,石碇區,中民里,14,345,470,338,808
108,12,942,貢寮區,美豐里,21,304,464,336,800
108,12,943,淡水區,草東里,24,345,405,381,786
108,12,944,金山區,大同里,9,280,378,408,786
108,12,945,永和區,大同里,18,325,417,366,783
108,12,946,雙溪區,魚行里,29,356,428,345,773
108,12,947,三峽區,有木里,14,365,457,309,766
108,12,948,永和區,新生里,18,311,382,370,752
108,12,949,淡水區,民安里,24,294,363,387,750
108,12,950,石碇區,隆盛里,12,303,417,324,741
108,12,951,三芝區,錫板里,17,299,429,309,738
108,12,952,金山區,六股里,8,241,393,339,732
108,12,953,貢寮區,雙玉里,23,299,405,310,715
108,12,954,金山區,三界里,10,210,333,379,712
108,12,955,貢寮區,龍門里,14,249,350,361,711
108,12,956,萬里區,溪底里,9,294,392,317,709
108,12,957,三峽區,插角里,16,366,410,292,702
108,12,958,石碇區,烏塗里,10,349,405,290,695
108,12,959,坪林區,水德里,10,281,368,327,695
108,12,960,三峽區,秀川里,10,279,339,348,687
108,12,961,石門區,茂林里,11,228,364,323,687
108,12,962,瑞芳區,龍安里,11,272,349,338,687
108,12,963,三芝區,茂長里,9,299,356,327,683
108,12,964,雙溪區,上林里,20,305,387,293,680
108,12,965,石碇區,永定里,10,273,364,309,673
108,12,966,萬里區,磺潭里,14,235,360,303,663
108,12,967,平溪區,嶺腳里,10,308,361,298,659
108,12,968,汐止區,東山里,20,290,337,312,649
108,12,969,三芝區,店子里,14,257,359,281,640
108,12,970,鶯歌區,建德里,8,213,348,288,636
108,12,971,金山區,永興里,15,239,335,300,635
108,12,972,淡水區,中和里,11,218,361,266,627
108,12,973,深坑區,阿柔里,9,229,348,278,626
108,12,974,烏來區,信賢里,9,198,278,318,596
108,12,975,三芝區,圓山里,12,214,341,249,590
108,12,976,金山區,豐漁里,9,172,296,284,580
108,12,977,三峽區,金圳里,12,228,317,224,541
108,12,978,三芝區,橫山里,19,224,313,224,537
108,12,979,金山區,和平里,8,194,247,271,518
108,12,980,瑞芳區,猴硐里,12,205,289,225,514
108,12,981,金山區,萬壽里,8,183,246,264,510
108,12,982,貢寮區,吉林里,19,241,320,189,509
108,12,983,雙溪區,雙溪里,19,226,257,250,507
108,12,984,瑞芳區,濂洞里,20,247,234,264,498
108,12,985,平溪區,石底里,10,218,255,230,485
108,12,986,瑞芳區,永慶里,13,233,246,223,469
108,12,987,瑞芳區,基山里,15,220,239,230,469
108,12,988,淡水區,新生里,13,241,210,253,463
108,12,989,萬里區,崁脚里,14,173,236,221,457
108,12,990,坪林區,石𥕢里,9,197,236,213,449
108,12,991,平溪區,東勢里,10,245,255,185,440
108,12,992,貢寮區,龍崗里,12,184,252,187,439
108,12,993,石碇區,石碇里,9,175,233,205,438
108,12,994,金山區,兩湖里,7,134,225,204,429
108,12,995,石碇區,豐田里,7,218,252,177,429
108,12,996,雙溪區,外柑里,17,224,261,167,428
108,12,997,平溪區,薯榔里,10,207,230,178,408
108,12,998,雙溪區,共和里,13,191,218,186,404
108,12,999,雙溪區,三港里,17,187,238,157,395
108,12,1000,雙溪區,長源里,20,192,221,165,386
108,12,1001,瑞芳區,新山里,11,187,209,175,384
108,12,1002,三重區,德厚里,6,165,180,197,377
108,12,1003,瑞芳區,頌德里,10,181,190,178,368
108,12,1004,平溪區,南山里,9,199,216,152,368
108,12,1005,汐止區,信望里,14,163,183,165,348
108,12,1006,瑞芳區,石山里,13,180,186,162,348
108,12,1007,三芝區,八賢里,10,139,192,155,347
108,12,1008,雙溪區,三貂里,20,158,191,151,342
108,12,1009,石門區,乾華里,7,147,195,142,337
108,12,1010,中和區,橫路里,7,133,173,163,336
108,12,1011,石碇區,豐林里,5,119,177,158,335
108,12,1012,石碇區,彭山里,6,157,185,150,335
108,12,1013,三峽區,三峽里,10,125,193,135,328
108,12,1014,瑞芳區,崇文里,10,169,170,157,327
108,12,1015,瑞芳區,濂新里,10,131,153,173,326
108,12,1016,瑞芳區,弓橋里,8,133,172,127,299
108,12,1017,石碇區,光明里,5,143,167,127,294
108,12,1018,瑞芳區,南雅里,9,93,148,142,290
108,12,1019,瑞芳區,光復里,14,140,152,131,283
108,12,1020,鶯歌區,東湖里,10,129,152,120,272
108,12,1021,平溪區,白石里,13,127,148,118,266
108,12,1022,平溪區,平溪里,10,115,139,124,263
108,12,1023,烏來區,孝義里,6,45,131,118,249
108,12,1024,平溪區,菁桐里,11,125,136,111,247
108,12,1025,瑞芳區,銅山里,12,102,111,92,203
108,12,1026,金山區,西湖里,7,57,114,79,193
108,12,1027,平溪區,平湖里,10,94,97,89,186
108,12,1028,瑞芳區,福住里,8,102,99,85,184
108,12,1029,瑞芳區,瓜山里,11,104,93,85,178
108,12,1030,平溪區,新寮里,9,95,101,63,164
108,12,1031,平溪區,望古里,8,103,89,67,156
108,12,1032,瑞芳區,碩仁里,10,72,83,61,144
總計,,,,,22371,1583999,1963658,2055038,4018696