年,月,排名,隸屬區,里,鄰數,戶數,男,女,合計
109,12,1,林口區,湖南里,48,11469,12821,14027,26848
109,12,2,林口區,南勢里,40,11710,12256,13636,25892
109,12,3,淡水區,崁頂里,15,10258,9778,10555,20333
109,12,4,三峽區,龍學里,45,7131,7894,9104,16998
109,12,5,樹林區,南園里,52,6693,7828,8432,16260
109,12,6,蘆洲區,正義里　,25,5672,7329,8009,15338
109,12,7,板橋區,溪福里,46,5212,7362,7628,14990
109,12,8,新店區,公崙里,37,5489,6620,7107,13727
109,12,9,新莊區,中原里,33,5456,6378,6886,13264
109,12,10,新莊區,西盛里,29,5034,6457,6661,13118
109,12,11,新莊區,立廷里,40,4987,6048,6769,12817
109,12,12,新莊區,雙鳳里,36,4734,6079,6248,12327
109,12,13,林口區,西林里,37,4590,5764,5808,11572
109,12,14,淡水區,北投里,22,5034,5435,6073,11508
109,12,15,新店區,香坡里,46,5040,5565,5830,11395
109,12,16,淡水區,竿蓁里,26,5974,5174,6173,11347
109,12,17,五股區,成泰里,34,4984,5622,5605,11227
109,12,18,板橋區,忠翠里,28,4551,5158,5913,11071
109,12,19,永和區,保順里,38,4553,5079,5872,10951
109,12,20,蘆洲區,水湳里　,25,3898,5360,5555,10915
109,12,21,新莊區,龍鳳里,30,4268,5061,5732,10793
109,12,22,三峽區,鳶山里,28,3990,5268,5390,10658
109,12,23,三峽區,龍埔里,36,3961,5181,5325,10506
109,12,24,板橋區,崑崙里,36,3785,5080,5275,10355
109,12,25,樹林區,柑園里,37,4211,4946,5310,10256
109,12,26,淡水區,大庄里,12,5059,4672,5415,10087
109,12,27,泰山區,全興里,25,3837,4864,5083,9947
109,12,28,蘆洲區,水河里　,18,3495,4873,5047,9920
109,12,29,三重區,過田里,28,5504,5469,4440,9909
109,12,30,新莊區,中平里,23,3683,4542,5305,9847
109,12,31,林口區,麗林里,32,3819,4667,5157,9824
109,12,32,板橋區,社後里,28,5520,5547,4268,9815
109,12,33,新莊區,頭前里,16,4332,4764,4992,9756
109,12,34,淡水區,新春里,15,3894,4617,5011,9628
109,12,35,新店區,柴埕里,34,3772,4617,4888,9505
109,12,36,板橋區,深丘里,32,3750,4533,4887,9420
109,12,37,中和區,平河里,67,3811,4528,4869,9397
109,12,38,新莊區,丹鳳里,28,3611,4577,4812,9389
109,12,39,新店區,張北里,32,4142,4388,4887,9275
109,12,40,新莊區,中信里,34,3206,4485,4761,9246
109,12,41,鶯歌區,尖山里,16,3423,4563,4524,9087
109,12,42,泰山區,義仁里,39,3310,4472,4583,9055
109,12,43,三重區,溪美里,31,3615,4313,4620,8933
109,12,44,鶯歌區,永昌里,22,2890,4420,4502,8922
109,12,45,板橋區,重慶里,38,3306,4321,4595,8916
109,12,46,土城區,埤林里,38,3191,4250,4531,8781
109,12,47,鶯歌區,二橋里,26,3106,4484,4296,8780
109,12,48,土城區,永寧里,37,3235,4372,4384,8756
109,12,49,三重區,碧華里,16,3856,4125,4557,8682
109,12,50,中和區,積穗里,45,3483,4107,4366,8473
109,12,51,汐止區,忠孝里,38,3876,4057,4367,8424
109,12,52,板橋區,新翠里,29,3298,3988,4378,8366
109,12,53,板橋區,海山里,23,2839,3960,4397,8357
109,12,54,土城區,清水里,32,2973,4062,4284,8346
109,12,55,新莊區,昌平里,21,3757,3861,4421,8282
109,12,56,中和區,新南里,49,3568,3816,4463,8279
109,12,57,新店區,安和里,28,3365,4022,4242,8264
109,12,58,五股區,水碓里,36,2991,4064,4122,8186
109,12,59,板橋區,華東里,32,3520,3875,4168,8043
109,12,60,蘆洲區,成功里　,29,2646,3872,4161,8033
109,12,61,板橋區,華江里,30,3271,3676,4279,7955
109,12,62,汐止區,中興里,32,3661,3849,4094,7943
109,12,63,新店區,五峯里,25,3484,3678,4252,7930
109,12,64,三峽區,永舘里,25,2856,3753,4078,7831
109,12,65,三峽區,安溪里,38,2821,3857,3970,7827
109,12,66,淡水區,新興里,9,3340,3623,4203,7826
109,12,67,三重區,光明里,30,3086,3788,3999,7787
109,12,68,三峽區,龍恩里,31,3273,3718,4064,7782
109,12,69,新莊區,光華里,28,2711,3812,3905,7717
109,12,70,林口區,東勢里,42,2758,3737,3945,7682
109,12,71,汐止區,厚德里,30,3132,3799,3864,7663
109,12,72,土城區,峯廷里,31,2659,3818,3810,7628
109,12,73,八里區,舊城里,22,3004,3720,3903,7623
109,12,74,鶯歌區,建國里,34,2733,3643,3928,7571
109,12,75,中和區,外南里,31,4339,4224,3339,7563
109,12,76,林口區,仁愛里,30,2983,3629,3922,7551
109,12,77,中和區,華新里,48,2910,3616,3889,7505
109,12,78,板橋區,福安里,25,3392,3563,3908,7471
109,12,79,板橋區,德翠里,26,2750,3663,3802,7465
109,12,80,八里區,龍源里,30,3275,3619,3835,7454
109,12,81,新店區,寶福里,29,3261,3599,3839,7438
109,12,82,淡水區,民生里,32,3559,3354,4064,7418
109,12,83,板橋區,成和里,24,2825,3619,3776,7395
109,12,84,汐止區,復興里,24,3355,3415,3970,7385
109,12,85,永和區,保安里,34,2960,3496,3867,7363
109,12,86,新莊區,裕民里,32,2654,3624,3709,7333
109,12,87,板橋區,華德里,32,3000,3490,3806,7296
109,12,88,五股區,成功里,34,3039,3610,3678,7288
109,12,89,新莊區,後港里,31,2587,3550,3729,7279
109,12,90,土城區,平和里,34,2469,3539,3717,7256
109,12,91,土城區,員林里,34,2982,3469,3774,7243
109,12,92,淡水區,福德里,19,3531,3468,3759,7227
109,12,93,中和區,中原里,24,3253,3509,3694,7203
109,12,94,蘆洲區,永康里　,22,2484,3446,3740,7186
109,12,95,汐止區,福安里,16,2846,3433,3741,7174
109,12,96,板橋區,中山里,32,3103,3504,3661,7165
109,12,97,中和區,中興里,38,2849,3434,3711,7145
109,12,98,泰山區,山腳里,45,2538,3576,3566,7142
109,12,99,土城區,清溪里,53,2718,3483,3650,7133
109,12,100,中和區,員山里,42,2847,3432,3666,7098
109,12,101,三芝區,埔坪里,35,2919,3565,3524,7089
109,12,102,三峽區,介壽里,28,2765,3603,3475,7078
109,12,103,土城區,延和里,32,2677,3365,3660,7025
109,12,104,板橋區,廣德里,25,2617,3408,3613,7021
109,12,105,新莊區,建安里,34,2560,3325,3588,6913
109,12,106,三重區,富貴里,32,2956,3305,3565,6870
109,12,107,蘆洲區,樓厝里　,24,2618,3305,3516,6821
109,12,108,中和區,德行里,42,2843,3233,3571,6804
109,12,109,三重區,成功里,21,2897,3199,3556,6755
109,12,110,新莊區,中港里,28,2249,3277,3474,6751
109,12,111,土城區,日和里,31,2604,3266,3438,6704
109,12,112,蘆洲區,永樂里　,27,2238,3306,3352,6658
109,12,113,汐止區,湖興里,38,3038,3276,3368,6644
109,12,114,新店區,信義里,31,3205,3139,3489,6628
109,12,115,中和區,連城里,48,2633,3135,3476,6611
109,12,116,淡水區,八勢里,14,3579,2969,3616,6585
109,12,117,三重區,田中里,30,2375,3192,3377,6569
109,12,118,中和區,秀景里,43,2903,3143,3362,6505
109,12,119,深坑區,埔新里,57,2652,3137,3341,6478
109,12,120,樹林區,保安里,34,2350,3222,3245,6467
109,12,121,五股區,成州里,27,2346,3272,3183,6455
109,12,122,淡水區,鄧公里,17,2699,3015,3437,6452
109,12,123,蘆洲區,恆德里　,21,2609,3078,3364,6442
109,12,124,新店區,新安里,25,3807,3372,3058,6430
109,12,125,三重區,田安里,42,2438,3080,3331,6411
109,12,126,三重區,光陽里,33,2641,3186,3217,6403
109,12,127,淡水區,竹圍里,15,3026,2910,3491,6401
109,12,128,蘆洲區,中原里　,29,2292,3114,3260,6374
109,12,129,新店區,德安里,28,2321,3171,3198,6369
109,12,130,板橋區,埔墘里,23,2600,3036,3332,6368
109,12,131,土城區,清和里,28,2236,3155,3200,6355
109,12,132,蘆洲區,南港里　,20,2088,3109,3244,6353
109,12,133,土城區,金城里,26,2411,2984,3356,6340
109,12,134,新莊區,民安里,33,2177,3045,3278,6323
109,12,135,新莊區,中美里,24,2362,3031,3277,6308
109,12,136,板橋區,溪頭里,25,2583,3079,3220,6299
109,12,137,三峽區,礁溪里,37,2406,3073,3225,6298
109,12,138,汐止區,江北里,30,2577,3241,3057,6298
109,12,139,樹林區,東陽里,31,2276,3128,3152,6280
109,12,140,新莊區,立基里,32,2329,3050,3229,6279
109,12,141,新店區,中正里,24,2665,2900,3360,6260
109,12,142,板橋區,懷翠里,26,2257,3093,3165,6258
109,12,143,三重區,永豐里,32,2173,3031,3204,6235
109,12,144,中和區,力行里,45,2460,2993,3229,6222
109,12,145,汐止區,湖光里,30,3021,2941,3274,6215
109,12,146,板橋區,溪洲里,21,2228,3003,3173,6176
109,12,147,新莊區,福興里,17,2207,3103,3060,6163
109,12,148,汐止區,自強里,25,2642,2936,3219,6155
109,12,149,蘆洲區,玉清里　,21,2337,2973,3166,6139
109,12,150,板橋區,港嘴里,25,2435,3005,3124,6129
109,12,151,新莊區,瓊林里,20,2181,3107,3019,6126
109,12,152,新店區,玫瑰里,28,2351,2920,3190,6110
109,12,153,三重區,永發里,27,2197,3050,3058,6108
109,12,154,土城區,明德里,30,2446,2829,3263,6092
109,12,155,樹林區,彭興里,41,2109,3016,3020,6036
109,12,156,淡水區,水碓里,20,2321,2919,3110,6029
109,12,157,樹林區,山佳里,21,1995,3050,2976,6026
109,12,158,新店區,中央里,20,2720,2809,3199,6008
109,12,159,三重區,六福里,29,2078,2952,3055,6007
109,12,160,中和區,安平里,43,2735,2836,3166,6002
109,12,161,鶯歌區,南鶯里,34,2163,2931,3059,5990
109,12,162,鶯歌區,中湖里,27,2067,3079,2901,5980
109,12,163,新店區,日興里,29,2278,2983,2991,5974
109,12,164,土城區,廣福里,33,2104,2930,2987,5917
109,12,165,新店區,新生里,26,2622,2770,3145,5915
109,12,166,新店區,雙城里,29,2216,2973,2909,5882
109,12,167,新店區,永平里,17,2184,2834,3039,5873
109,12,168,中和區,景福里,44,2687,2745,3113,5858
109,12,169,汐止區,秀峰里,23,2817,3051,2757,5808
109,12,170,三重區,福祉里,20,2343,2793,3011,5804
109,12,171,林口區,林口里,29,2207,2841,2936,5777
109,12,172,土城區,永富里,27,2158,2854,2920,5774
109,12,173,土城區,員仁里,33,2033,2842,2931,5773
109,12,174,汐止區,北山里,25,2705,2728,3033,5761
109,12,175,蘆洲區,仁德里　,20,2005,2856,2900,5756
109,12,176,鶯歌區,鳳鳴里,29,2221,2879,2859,5738
109,12,177,蘆洲區,鷺江里　,21,2097,2812,2924,5736
109,12,178,汐止區,新昌里,35,2351,2770,2947,5717
109,12,179,中和區,瓦磘里,29,2300,2741,2964,5705
109,12,180,中和區,錦和里,21,2065,2787,2915,5702
109,12,181,板橋區,玉光里,21,2256,2700,2997,5697
109,12,182,土城區,裕生里,39,2153,2769,2919,5688
109,12,183,淡水區,油車里,20,2409,2746,2935,5681
109,12,184,土城區,埤塘里,17,2997,3272,2396,5668
109,12,185,金山區,金美里,35,2014,2693,2973,5666
109,12,186,三重區,永清里,32,2014,2737,2927,5664
109,12,187,蘆洲區,九芎里　,27,1964,2760,2902,5662
109,12,188,新店區,安昌里,17,2434,2643,3007,5650
109,12,189,土城區,員福里,28,2096,2812,2824,5636
109,12,190,新莊區,榮和里,25,3332,3282,2353,5635
109,12,191,新莊區,信義里,25,2100,2688,2941,5629
109,12,192,新莊區,思源里,22,2118,2715,2870,5585
109,12,193,三芝區,埔頭里,42,2241,2742,2839,5581
109,12,194,新莊區,自立里,26,2198,2657,2922,5579
109,12,195,蘆洲區,仁義里　,18,2811,3016,2551,5567
109,12,196,五股區,德音里,30,2027,2757,2796,5553
109,12,197,樹林區,中山里,25,1912,2814,2737,5551
109,12,198,板橋區,宏翠里,21,2525,2614,2934,5548
109,12,199,新店區,青潭里,22,2279,2684,2862,5546
109,12,200,新店區,江陵里,23,2344,2596,2947,5543
109,12,201,三重區,永福里,30,2014,2666,2870,5536
109,12,202,蘆洲區,光華里　,19,2030,2630,2903,5533
109,12,203,土城區,頂福里,25,2090,2751,2765,5516
109,12,204,新莊區,海山里,24,2147,2672,2834,5506
109,12,205,板橋區,純翠里,16,2096,2645,2860,5505
109,12,206,新店區,寶安里,39,2616,2505,2998,5503
109,12,207,蘆洲區,永安里　,19,1899,2637,2866,5503
109,12,208,三峽區,中正里,34,1806,2772,2728,5500
109,12,209,新店區,寶興里,24,2576,2588,2912,5500
109,12,210,中和區,景平里,43,2517,2559,2941,5500
109,12,211,樹林區,彭福里,33,2009,2719,2780,5499
109,12,212,三重區,大有里,25,2042,2708,2775,5483
109,12,213,汐止區,建成里,23,2423,2535,2935,5470
109,12,214,板橋區,華中里,20,1975,2733,2725,5458
109,12,215,蘆洲區,仁愛里　,19,1873,2666,2789,5455
109,12,216,三重區,五華里,18,2132,2615,2814,5429
109,12,217,汐止區,金龍里,41,2505,2613,2808,5421
109,12,218,蘆洲區,長安里　,19,1824,2712,2707,5419
109,12,219,板橋區,聚安里,28,2004,2708,2705,5413
109,12,220,新莊區,中隆里,27,2073,2587,2806,5393
109,12,221,新店區,美潭里,20,2188,2644,2746,5390
109,12,222,新店區,員潭里,19,2311,2606,2771,5377
109,12,223,樹林區,樹西里,32,2056,2651,2720,5371
109,12,224,新莊區,南港里,22,1982,2625,2734,5359
109,12,225,樹林區,文林里,36,1911,2595,2758,5353
109,12,226,汐止區,崇德里,29,2130,2625,2718,5343
109,12,227,新莊區,福基里,17,2408,2635,2702,5337
109,12,228,三重區,永順里,36,1901,2562,2772,5334
109,12,229,中和區,文元里,35,2019,2593,2730,5323
109,12,230,新店區,永安里,25,2024,2605,2714,5319
109,12,231,永和區,福和里,23,2320,2505,2814,5319
109,12,232,板橋區,自強里,35,2077,2596,2716,5312
109,12,233,板橋區,湳興里,25,2281,2527,2784,5311
109,12,234,汐止區,拱北里,31,2166,2694,2608,5302
109,12,235,新莊區,成德里,23,1835,2577,2722,5299
109,12,236,板橋區,江翠里,20,2078,2602,2692,5294
109,12,237,樹林區,東昇里,28,1949,2608,2660,5268
109,12,238,汐止區,康福里,24,2726,2463,2793,5256
109,12,239,板橋區,中正里,27,2120,2553,2702,5255
109,12,240,新莊區,光明里,21,1728,2548,2694,5242
109,12,241,板橋區,福丘里,19,2292,2400,2835,5235
109,12,242,新莊區,忠孝里,29,2183,2509,2723,5232
109,12,243,鶯歌區,大湖里,24,1942,2624,2608,5232
109,12,244,中和區,南山里,38,2204,2536,2689,5225
109,12,245,中和區,民安里,25,1949,2589,2635,5224
109,12,246,土城區,頂埔里,31,2040,2550,2665,5215
109,12,247,土城區,樂利里,36,1962,2512,2698,5210
109,12,248,新店區,中興里,18,2335,2464,2746,5210
109,12,249,鶯歌區,永吉里,32,1683,2599,2608,5207
109,12,250,中和區,華南里,24,2110,2555,2649,5204
109,12,251,中和區,復興里,55,2072,2425,2779,5204
109,12,252,三重區,慈祐里,26,1934,2562,2640,5202
109,12,253,泰山區,貴和里,42,1991,2549,2649,5198
109,12,254,樹林區,彭厝里,40,1744,2576,2618,5194
109,12,255,樹林區,獇寮里,27,1830,2609,2574,5183
109,12,256,板橋區,福德里,28,1978,2573,2606,5179
109,12,257,新莊區,立言里,24,1888,2463,2714,5177
109,12,258,三重區,永德里,34,1916,2534,2642,5176
109,12,259,中和區,秀明里,56,2394,2355,2806,5161
109,12,260,新莊區,全泰里,27,1940,2534,2624,5158
109,12,261,新莊區,立泰里,21,1900,2457,2700,5157
109,12,262,永和區,中溪里,21,2096,2554,2595,5149
109,12,263,中和區,福祥里,38,2108,2503,2635,5138
109,12,264,板橋區,民族里,20,1813,2480,2652,5132
109,12,265,中和區,內南里,39,1843,2586,2545,5131
109,12,266,樹林區,潭底里,33,2197,2808,2322,5130
109,12,267,土城區,大安里,25,2031,2551,2562,5113
109,12,268,蘆洲區,光明里　,23,1796,2484,2626,5110
109,12,269,泰山區,義學里,27,1857,2529,2571,5100
109,12,270,中和區,自強里,25,1916,2493,2606,5099
109,12,271,土城區,安和里,28,1845,2513,2581,5094
109,12,272,板橋區,龍翠里,20,2002,2479,2604,5083
109,12,273,土城區,廷寮里,23,1743,2522,2548,5070
109,12,274,土城區,學士里,27,1864,2434,2630,5064
109,12,275,永和區,秀和里,21,2067,2388,2672,5060
109,12,276,中和區,佳和里,40,2197,2387,2665,5052
109,12,277,永和區,豫溪里,17,2797,2568,2447,5015
109,12,278,永和區,和平里,24,2083,2361,2645,5006
109,12,279,林口區,中湖里,17,1901,2473,2515,4988
109,12,280,淡水區,正德里,14,2132,2264,2713,4977
109,12,281,板橋區,長安里,19,1740,2395,2579,4974
109,12,282,樹林區,三興里,31,1814,2557,2409,4966
109,12,283,萬里區,萬里里,35,1488,2455,2511,4966
109,12,284,中和區,景安里,44,2124,2402,2564,4966
109,12,285,新莊區,和平里,21,1774,2441,2519,4960
109,12,286,中和區,碧河里,27,2124,2422,2532,4954
109,12,287,汐止區,保長里,22,2119,2445,2508,4953
109,12,288,永和區,潭安里,20,2019,2365,2573,4938
109,12,289,淡水區,新民里,12,2026,2348,2587,4935
109,12,290,永和區,永元里,21,1946,2309,2607,4916
109,12,291,八里區,訊塘里,23,1932,2414,2488,4902
109,12,292,汐止區,北峰里,26,2031,2449,2439,4888
109,12,293,中和區,秀峰里,47,2365,2204,2682,4886
109,12,294,新店區,吉祥里,24,1839,2315,2560,4875
109,12,295,永和區,民族里,22,1902,2302,2568,4870
109,12,296,板橋區,明翠里,22,1974,2374,2491,4865
109,12,297,永和區,保平里,25,1961,2324,2539,4863
109,12,298,汐止區,智慧里,24,2254,2244,2614,4858
109,12,299,新莊區,光正里,22,1623,2378,2475,4853
109,12,300,新莊區,四維里,22,1853,2305,2547,4852
109,12,301,板橋區,東丘里,20,1691,2331,2518,4849
109,12,302,土城區,沛陂里,21,1915,2433,2415,4848
109,12,303,中和區,秀福里,36,1988,2350,2496,4846
109,12,304,中和區,忠孝里,39,1870,2388,2458,4846
109,12,305,汐止區,茄苳里,27,1803,2439,2407,4846
109,12,306,板橋區,柏翠里,18,2158,2321,2523,4844
109,12,307,板橋區,港德里,29,1935,2363,2481,4844
109,12,308,淡水區,學府里,18,2232,2295,2539,4834
109,12,309,三重區,福隆里,19,1860,2317,2513,4830
109,12,310,汐止區,文化里,21,2048,2342,2488,4830
109,12,311,永和區,民樂里,22,1939,2342,2487,4829
109,12,312,新莊區,合鳳里,25,1741,2395,2418,4813
109,12,313,五股區,興珍里,40,1696,2477,2335,4812
109,12,314,三重區,幸福里,36,1902,2356,2455,4811
109,12,315,土城區,日新里,27,1771,2367,2438,4805
109,12,316,汐止區,秀山里,26,1914,2368,2425,4793
109,12,317,板橋區,埤墘里,17,1834,2273,2518,4791
109,12,318,新店區,中山里,26,2326,2169,2619,4788
109,12,319,板橋區,大豐里,22,1813,2318,2446,4764
109,12,320,新莊區,光榮里,20,1567,2335,2427,4762
109,12,321,中和區,壽德里,31,1863,2270,2488,4758
109,12,322,汐止區,城中里,28,2020,2222,2531,4753
109,12,323,永和區,潭墘里,25,1956,2166,2584,4750
109,12,324,中和區,安穗里,19,1858,2284,2464,4748
109,12,325,淡水區,沙崙里,8,2078,2312,2422,4734
109,12,326,汐止區,橫科里,42,2157,2332,2386,4718
109,12,327,新莊區,恆安里,24,1697,2272,2438,4710
109,12,328,樹林區,金寮里,24,1642,2325,2376,4701
109,12,329,新莊區,全安里,22,1816,2235,2463,4698
109,12,330,中和區,德穗里,32,1834,2267,2431,4698
109,12,331,五股區,德泰里,22,1758,2288,2404,4692
109,12,332,淡水區,民權里,17,2248,2146,2543,4689
109,12,333,永和區,民權里,26,1745,2237,2448,4685
109,12,334,新莊區,中和里,30,1691,2291,2386,4677
109,12,335,中和區,明穗里,33,1684,2342,2331,4673
109,12,336,泰山區,楓樹里,28,1751,2332,2338,4670
109,12,337,三重區,博愛里,22,1647,2254,2409,4663
109,12,338,蘆洲區,永德里　,20,1586,2283,2378,4661
109,12,339,土城區,貨饒里,22,1878,2283,2372,4655
109,12,340,土城區,復興里,34,1694,2293,2351,4644
109,12,341,汐止區,東勢里,22,2293,2258,2375,4633
109,12,342,樹林區,圳福里,27,1612,2297,2329,4626
109,12,343,中和區,秀山里,31,1830,2210,2413,4623
109,12,344,新莊區,中泰里,22,1777,2278,2345,4623
109,12,345,板橋區,新民里,26,1750,2238,2384,4622
109,12,346,鶯歌區,鳳祥里,33,1676,2333,2289,4622
109,12,347,汐止區,白雲里,26,1906,2306,2310,4616
109,12,348,土城區,延壽里,27,1725,2299,2278,4577
109,12,349,中和區,和興里,42,1939,2154,2401,4555
109,12,350,板橋區,莊敬里,17,1688,2163,2391,4554
109,12,351,土城區,永豐里,27,1647,2234,2317,4551
109,12,352,鶯歌區,北鶯里,20,1971,2297,2244,4541
109,12,353,新莊區,昌隆里,15,1701,2150,2381,4531
109,12,354,五股區,五股里,28,1963,2395,2133,4528
109,12,355,中和區,福美里,35,1751,2209,2319,4528
109,12,356,中和區,廟美里,40,1778,2202,2321,4523
109,12,357,中和區,嘉慶里,24,1687,2206,2311,4517
109,12,358,土城區,員信里,25,1649,2216,2292,4508
109,12,359,土城區,延吉里,22,1605,2272,2227,4499
109,12,360,永和區,下溪里,15,1890,2162,2334,4496
109,12,361,林口區,菁湖里,23,1626,2230,2266,4496
109,12,362,三重區,仁華里,27,1722,2163,2315,4478
109,12,363,新店區,中華里,21,2014,2095,2381,4476
109,12,364,板橋區,堂春里,19,1528,2196,2270,4466
109,12,365,板橋區,信義里,21,1760,2179,2283,4462
109,12,366,三重區,民生里,28,1757,2189,2272,4461
109,12,367,三重區,光田里,27,1947,2141,2306,4447
109,12,368,中和區,信和里,41,1659,2186,2258,4444
109,12,369,金山區,美田里,25,1447,2100,2343,4443
109,12,370,板橋區,忠誠里,17,1780,2130,2312,4442
109,12,371,板橋區,雙玉里,18,1613,2121,2314,4435
109,12,372,板橋區,新生里,24,1595,2188,2243,4431
109,12,373,板橋區,振興里,17,1689,2164,2266,4430
109,12,374,新莊區,思賢里,21,1614,2187,2233,4420
109,12,375,中和區,中安里,40,2095,2027,2371,4398
109,12,376,板橋區,漢生里,22,1709,2131,2266,4397
109,12,377,新莊區,幸福里,30,1640,2100,2293,4393
109,12,378,中和區,錦中里,22,1645,2142,2249,4391
109,12,379,中和區,東南里,32,1792,2125,2260,4385
109,12,380,中和區,崇南里,41,1922,2091,2290,4381
109,12,381,淡水區,新義里,14,1568,2138,2240,4378
109,12,382,永和區,得和里,25,1854,2035,2328,4363
109,12,383,中和區,安順里,34,1967,2045,2317,4362
109,12,384,林口區,麗園里,19,1555,2131,2223,4354
109,12,385,中和區,福善里,42,1860,2031,2314,4345
109,12,386,三重區,五常里,34,1479,2161,2183,4344
109,12,387,三重區,永安里,20,1562,2121,2222,4343
109,12,388,土城區,延祿里,21,1567,2146,2195,4341
109,12,389,板橋區,僑中里,16,1555,2164,2173,4337
109,12,390,泰山區,同榮里,30,1531,2120,2209,4329
109,12,391,三峽區,大埔里,22,1514,2311,2014,4325
109,12,392,板橋區,華興里,18,1703,2091,2233,4324
109,12,393,八里區,埤頭里,28,1682,2147,2168,4315
109,12,394,板橋區,香社里,21,1599,2139,2176,4315
109,12,395,新店區,新和里,23,1774,2052,2257,4309
109,12,396,中和區,福南里,29,1594,2076,2231,4307
109,12,397,樹林區,樹南里,29,1559,2135,2170,4305
109,12,398,新店區,福民里,25,1899,2017,2280,4297
109,12,399,蘆洲區,中路里　,17,1532,2125,2172,4297
109,12,400,板橋區,振義里,19,1666,2112,2183,4295
109,12,401,蘆洲區,延平里　,17,1553,2136,2158,4294
109,12,402,永和區,店街里,19,1910,1932,2352,4284
109,12,403,板橋區,和平里,16,1723,1999,2281,4280
109,12,404,三重區,福德里,20,1780,2029,2250,4279
109,12,405,三峽區,八張里,20,1542,2127,2140,4267
109,12,406,永和區,民本里,17,1630,1995,2268,4263
109,12,407,永和區,永安里,24,1828,1963,2298,4261
109,12,408,樹林區,三多里,21,1481,2162,2087,4249
109,12,409,中和區,民生里,30,1769,2021,2196,4217
109,12,410,林口區,東林里,27,1506,2143,2065,4208
109,12,411,板橋區,廣福里,12,1581,2057,2149,4206
109,12,412,五股區,集賢里,22,1490,2114,2091,4205
109,12,413,板橋區,五權里,19,1568,2091,2114,4205
109,12,414,樹林區,三福里,32,1541,2075,2128,4203
109,12,415,樹林區,光興里,21,1452,2110,2087,4197
109,12,416,蘆洲區,信義里　,27,1452,2079,2117,4196
109,12,417,永和區,民生里,22,1566,1964,2232,4196
109,12,418,永和區,秀林里,20,1693,2031,2161,4192
109,12,419,淡水區,中興里,18,1761,2022,2161,4183
109,12,420,中和區,福真里,43,1722,2051,2131,4182
109,12,421,三重區,田心里,32,1629,2051,2125,4176
109,12,422,中和區,仁和里,42,1504,2068,2105,4173
109,12,423,泰山區,貴子里,29,1679,2075,2097,4172
109,12,424,新莊區,民有里,20,1573,1975,2188,4163
109,12,425,鶯歌區,鳳福里,29,1683,2040,2111,4151
109,12,426,板橋區,福祿里,19,1637,1953,2183,4136
109,12,427,三重區,五順里,35,1520,2041,2078,4119
109,12,428,中和區,明德里,28,1558,2037,2082,4119
109,12,429,中和區,嘉新里,22,1475,2026,2079,4105
109,12,430,瑞芳區,爪峯里,14,1596,2010,2093,4103
109,12,431,新店區,達觀里,21,2049,1884,2218,4102
109,12,432,淡水區,幸福里,19,1638,1977,2118,4095
109,12,433,泰山區,同興里,24,1445,1988,2103,4091
109,12,434,板橋區,文翠里,19,1591,2007,2079,4086
109,12,435,三重區,清和里,20,1940,1943,2143,4086
109,12,436,板橋區,金華里,23,1485,1997,2087,4084
109,12,437,新莊區,立志里,16,1547,1984,2095,4079
109,12,438,永和區,水源里,21,1654,1930,2148,4078
109,12,439,三重區,中興里,37,1649,2042,2032,4074
109,12,440,板橋區,香丘里,14,1556,1944,2130,4074
109,12,441,永和區,雙和里,17,1727,1842,2218,4060
109,12,442,板橋區,大安里,24,1531,2055,2003,4058
109,12,443,板橋區,幸福里,19,1540,1985,2070,4055
109,12,444,板橋區,文聖里,17,1447,1968,2082,4050
109,12,445,中和區,中正里,34,1557,1951,2097,4048
109,12,446,五股區,集福里,26,1560,2048,1990,4038
109,12,447,新店區,明德里,27,1820,1916,2121,4037
109,12,448,永和區,秀朗里,23,1593,1969,2063,4032
109,12,449,板橋區,公館里,21,1510,1999,2030,4029
109,12,450,三重區,崇德里,32,1553,2023,1999,4022
109,12,451,三重區,五福里,17,1671,1931,2086,4017
109,12,452,土城區,柑林里,21,1591,1909,2102,4011
109,12,453,新莊區,化成里,15,1580,2000,2001,4001
109,12,454,五股區,六福里,23,1504,1954,2043,3997
109,12,455,中和區,錦盛里,26,1465,1958,2031,3989
109,12,456,樹林區,和平里,28,1402,1980,1996,3976
109,12,457,板橋區,居仁里,17,1551,1961,2014,3975
109,12,458,新莊區,昌信里,17,1465,1922,2048,3970
109,12,459,板橋區,浮洲里,25,1500,2004,1964,3968
109,12,460,中和區,漳和里,36,1760,1904,2057,3961
109,12,461,三重區,重明里,19,1615,1938,2017,3955
109,12,462,泰山區,明志里,24,1448,1940,2008,3948
109,12,463,新店區,福德里,20,1644,1826,2119,3945
109,12,464,中和區,國光里,39,1509,1917,2017,3934
109,12,465,新店區,百忍里,22,1639,1816,2106,3922
109,12,466,蘆洲區,保佑里　,18,1426,1939,1982,3921
109,12,467,永和區,安和里,18,1735,1799,2112,3911
109,12,468,新莊區,富民里,21,1488,1905,2004,3909
109,12,469,新店區,大同里,26,1756,1888,2014,3902
109,12,470,新莊區,民全里,17,1391,1909,1992,3901
109,12,471,三重區,六合里,25,1525,1934,1961,3895
109,12,472,板橋區,鄉雲里,21,1671,1853,2030,3883
109,12,473,蘆洲區,保新里　,12,1471,1892,1990,3882
109,12,474,三重區,福樂里,23,1535,1884,1989,3873
109,12,475,中和區,枋寮里,35,1586,1888,1984,3872
109,12,476,中和區,景文里,29,1655,1834,2033,3867
109,12,477,新莊區,豐年里,16,1384,1893,1959,3852
109,12,478,樹林區,圳安里,23,1375,1928,1922,3850
109,12,479,永和區,桂林里,18,1539,1866,1981,3847
109,12,480,板橋區,後埔里,17,1593,1869,1978,3847
109,12,481,三重區,培德里,24,1438,1885,1960,3845
109,12,482,新莊區,萬安里,18,1492,1852,1991,3843
109,12,483,板橋區,吉翠里,16,1390,1863,1980,3843
109,12,484,中和區,秀水里,28,1585,1843,1995,3838
109,12,485,板橋區,大觀里,14,1345,1881,1953,3834
109,12,486,五股區,民義里,23,1393,1919,1913,3832
109,12,487,泰山區,貴賢里,27,1515,1860,1967,3827
109,12,488,樹林區,樹興里,27,1420,1862,1965,3827
109,12,489,新店區,百福里,24,1680,1762,2063,3825
109,12,490,新店區,小城里,18,1444,1854,1963,3817
109,12,491,板橋區,聯翠里,17,1679,1782,2030,3812
109,12,492,板橋區,國泰里,15,1472,1819,1973,3792
109,12,493,新莊區,立功里,25,1421,1847,1937,3784
109,12,494,新店區,大豐里,24,1603,1763,2014,3777
109,12,495,新莊區,仁義里,20,1428,1897,1878,3775
109,12,496,板橋區,國光里,20,1556,1806,1968,3774
109,12,497,泰山區,福興里,25,1416,1848,1924,3772
109,12,498,新莊區,昌明里,18,1338,1835,1937,3772
109,12,499,汐止區,福山里,18,1775,1771,1995,3766
109,12,500,新莊區,中宏里,20,1385,1854,1908,3762
109,12,501,永和區,竹林里,30,1539,1793,1967,3760
109,12,502,板橋區,廣新里,24,1302,1835,1923,3758
109,12,503,三重區,厚德里,22,1457,1839,1915,3754
109,12,504,三峽區,二鬮里,24,1384,1892,1857,3749
109,12,505,八里區,米倉里,24,1527,1911,1833,3744
109,12,506,樹林區,樹福里,20,1483,1785,1957,3742
109,12,507,板橋區,永安里,17,1456,1814,1922,3736
109,12,508,樹林區,大同里,18,1330,1772,1958,3730
109,12,509,樹林區,樹德里,25,1405,1831,1894,3725
109,12,510,板橋區,溪北里,18,1368,1838,1887,3725
109,12,511,鶯歌區,南靖里,20,1278,1891,1819,3710
109,12,512,三重區,重陽里,25,1433,1837,1870,3707
109,12,513,中和區,福和里,32,1499,1826,1870,3696
109,12,514,板橋區,華翠里,19,1386,1778,1916,3694
109,12,515,中和區,安樂里,33,1625,1726,1964,3690
109,12,516,中和區,員富里,23,1488,1854,1824,3678
109,12,517,泰山區,黎明里,17,1325,1792,1882,3674
109,12,518,土城區,學府里,22,1255,1757,1915,3672
109,12,519,新莊區,中全里,18,1329,1855,1814,3669
109,12,520,瑞芳區,新峰里,14,1378,1836,1830,3666
109,12,521,八里區,大崁里,17,1430,1879,1785,3664
109,12,522,板橋區,福星里,20,1374,1739,1917,3656
109,12,523,土城區,廣興里,18,1354,1733,1920,3653
109,12,524,三峽區,中埔里,15,1364,1784,1865,3649
109,12,525,蘆洲區,復興里　,13,1301,1822,1824,3646
109,12,526,五股區,五福里,23,1317,1866,1769,3635
109,12,527,五股區,福德里,19,1416,1811,1815,3626
109,12,528,板橋區,新海里,21,1251,1801,1802,3603
109,12,529,萬里區,野柳里,19,1104,1720,1883,3603
109,12,530,中和區,正南里,30,1383,1830,1773,3603
109,12,531,中和區,景新里,32,1494,1705,1895,3600
109,12,532,板橋區,建國里,31,1436,1731,1866,3597
109,12,533,樹林區,中華里,19,1241,1707,1879,3586
109,12,534,五股區,成德里,23,1364,1780,1804,3584
109,12,535,三重區,福民里,19,1358,1763,1821,3584
109,12,536,新店區,明城里,21,1409,1728,1854,3582
109,12,537,樹林區,樹人里,21,1258,1735,1840,3575
109,12,538,中和區,泰安里,42,1465,1679,1892,3571
109,12,539,中和區,建和里,34,1418,1725,1842,3567
109,12,540,新莊區,文聖里,29,1419,1660,1905,3565
109,12,541,永和區,上林里,21,1490,1728,1830,3558
109,12,542,中和區,秀成里,31,1369,1740,1813,3553
109,12,543,三重區,福田里,24,1260,1781,1758,3539
109,12,544,三重區,三民里,15,1304,1744,1784,3528
109,12,545,板橋區,文化里,17,1414,1691,1836,3527
109,12,546,板橋區,景星里,24,1552,1697,1827,3524
109,12,547,深坑區,深坑里,41,1479,1722,1795,3517
109,12,548,中和區,秀仁里,23,1487,1690,1824,3514
109,12,549,汐止區,橋東里,20,1453,1655,1847,3502
109,12,550,三重區,立德里,22,1319,1712,1787,3499
109,12,551,新莊區,興漢里,32,1376,1710,1776,3486
109,12,552,三重區,慈愛里,25,1357,1723,1762,3485
109,12,553,板橋區,朝陽里,16,1291,1655,1821,3476
109,12,554,永和區,河堤里,19,1559,1645,1831,3476
109,12,555,三重區,富華里,24,1386,1735,1732,3467
109,12,556,三重區,永盛里,25,1272,1664,1796,3460
109,12,557,永和區,福林里,25,1445,1662,1792,3454
109,12,558,蘆洲區,中華里　,14,1284,1677,1773,3450
109,12,559,中和區,國華里,22,1325,1704,1739,3443
109,12,560,永和區,智光里,32,1385,1643,1800,3443
109,12,561,板橋區,松翠里,18,1427,1642,1799,3441
109,12,562,板橋區,光復里,25,1382,1758,1682,3440
109,12,563,新店區,下城里,14,1420,1762,1677,3439
109,12,564,永和區,永貞里,20,1422,1623,1813,3436
109,12,565,蘆洲區,得勝里　,21,1301,1676,1753,3429
109,12,566,三重區,龍濱里,20,1289,1679,1737,3416
109,12,567,土城區,中正里,18,1268,1600,1798,3398
109,12,568,汐止區,忠山里,22,1591,1628,1770,3398
109,12,569,蘆洲區,忠義里　,14,1231,1650,1745,3395
109,12,570,蘆洲區,福安里　,11,1208,1666,1729,3395
109,12,571,土城區,學成里,18,1185,1671,1705,3376
109,12,572,泰山區,新明里,25,1214,1655,1714,3369
109,12,573,蘆洲區,樹德里　,14,1265,1691,1664,3355
109,12,574,瑞芳區,吉安里,16,1290,1709,1645,3354
109,12,575,板橋區,福壽里,16,1285,1636,1710,3346
109,12,576,中和區,冠穗里,24,1287,1671,1670,3341
109,12,577,新店區,復興里,21,1451,1565,1760,3325
109,12,578,樹林區,東山里,20,1165,1690,1630,3320
109,12,579,汐止區,福德里,18,1467,1593,1715,3308
109,12,580,永和區,永興里,26,1327,1570,1735,3305
109,12,581,永和區,河濱里,19,1327,1607,1692,3299
109,12,582,三重區,仁忠里,23,1272,1619,1677,3296
109,12,583,蘆洲區,溪墘里　,15,1240,1591,1701,3292
109,12,584,板橋區,介壽里,17,1291,1551,1732,3283
109,12,585,新店區,百和里,22,1389,1574,1699,3273
109,12,586,樹林區,育英里,20,1233,1616,1649,3265
109,12,587,中和區,清穗里,24,1290,1612,1653,3265
109,12,588,板橋區,新興里,17,1532,1551,1681,3232
109,12,589,永和區,中興里,17,1445,1488,1737,3225
109,12,590,中和區,安和里,27,1412,1527,1690,3217
109,12,591,新店區,國豐里,22,1380,1455,1760,3215
109,12,592,中和區,景南里,34,1326,1541,1673,3214
109,12,593,三峽區,溪東里,16,1087,1638,1559,3197
109,12,594,新店區,粗坑里,20,1359,1521,1664,3185
109,12,595,永和區,秀元里,20,1240,1514,1670,3184
109,12,596,汐止區,興福里,20,1449,1504,1679,3183
109,12,597,新莊區,八德里,16,1214,1545,1637,3182
109,12,598,土城區,頂新里,10,1274,1515,1660,3175
109,12,599,深坑區,土庫里,36,1222,1594,1574,3168
109,12,600,土城區,青山里,18,1083,1568,1600,3168
109,12,601,板橋區,仁愛里,20,1182,1569,1595,3164
109,12,602,新店區,太平里,20,1426,1467,1688,3155
109,12,603,新店區,建國里,18,1353,1455,1699,3154
109,12,604,三重區,尚德里,29,1226,1512,1640,3152
109,12,605,新莊區,後德里,15,1115,1593,1548,3141
109,12,606,土城區,青雲里,21,1132,1515,1621,3136
109,12,607,土城區,瑞興里,26,1236,1529,1605,3134
109,12,608,中和區,興南里,37,1275,1529,1605,3134
109,12,609,蘆洲區,得仁里　,15,1161,1522,1605,3127
109,12,610,五股區,貿商里,25,1243,1496,1627,3123
109,12,611,板橋區,文德里,12,1192,1531,1565,3096
109,12,612,永和區,民富里,15,1124,1503,1585,3088
109,12,613,新莊區,民本里,19,1150,1555,1525,3080
109,12,614,三重區,福安里,25,1242,1515,1560,3075
109,12,615,板橋區,正泰里,16,1128,1460,1612,3072
109,12,616,萬里區,北基里,23,1456,1509,1559,3068
109,12,617,萬里區,大鵬里,24,1019,1532,1520,3052
109,12,618,中和區,吉興里,21,1302,1381,1669,3050
109,12,619,汐止區,宜興里,25,1491,1421,1624,3045
109,12,620,板橋區,港尾里,15,1130,1447,1594,3041
109,12,621,三重區,維德里,21,1173,1488,1551,3039
109,12,622,板橋區,滿翠里,20,1147,1458,1580,3038
109,12,623,永和區,協和里,22,1313,1460,1574,3034
109,12,624,板橋區,青翠里,15,1208,1541,1489,3030
109,12,625,新莊區,中華里,15,1237,1506,1524,3030
109,12,626,永和區,光明里,17,1306,1373,1652,3025
109,12,627,三重區,永吉里,20,1178,1441,1577,3018
109,12,628,板橋區,百壽里,17,1240,1393,1623,3016
109,12,629,板橋區,光仁里,15,1045,1473,1541,3014
109,12,630,中和區,正行里,19,1257,1414,1598,3012
109,12,631,汐止區,保新里,13,1439,1466,1524,2990
109,12,632,板橋區,長壽里,11,1106,1468,1515,2983
109,12,633,板橋區,九如里,16,1106,1434,1537,2971
109,12,634,中和區,頂南里,26,1103,1452,1518,2970
109,12,635,樹林區,圳民里,16,1124,1559,1405,2964
109,12,636,永和區,秀成里,17,1183,1450,1512,2962
109,12,637,永和區,民治里,24,1236,1314,1646,2960
109,12,638,新莊區,光和里,19,980,1421,1526,2947
109,12,639,泰山區,福泰里,25,1052,1486,1458,2944
109,12,640,淡水區,北新里,20,1404,1420,1521,2941
109,12,641,三重區,大園里,22,1171,1459,1476,2935
109,12,642,汐止區,大同里,23,1282,1377,1554,2931
109,12,643,板橋區,仁翠里,16,1109,1421,1509,2930
109,12,644,汐止區,山光里,14,1257,1417,1512,2929
109,12,645,板橋區,莒光里,17,1164,1424,1504,2928
109,12,646,中和區,嘉穗里,15,1048,1460,1462,2922
109,12,647,樹林區,太順里,16,950,1479,1413,2892
109,12,648,板橋區,龍安里,20,1086,1402,1484,2886
109,12,649,板橋區,自立里,20,1106,1385,1490,2875
109,12,650,永和區,文化里,18,1230,1357,1513,2870
109,12,651,烏來區,烏來里,15,900,1394,1471,2865
109,12,652,板橋區,西安里,14,1079,1379,1483,2862
109,12,653,萬里區,龜吼里,20,1000,1460,1391,2851
109,12,654,新店區,華城里,13,1306,1328,1510,2838
109,12,655,中和區,中山里,22,1094,1352,1485,2837
109,12,656,三重區,中山里,22,1233,1378,1451,2829
109,12,657,汐止區,湖蓮里,12,1494,1301,1527,2828
109,12,658,中和區,民有里,24,1112,1381,1424,2805
109,12,659,新店區,忠孝里,15,1303,1347,1457,2804
109,12,660,新店區,新德里,20,1282,1294,1499,2793
109,12,661,新店區,美城里,14,1100,1343,1449,2792
109,12,662,永和區,秀得里,20,1077,1336,1454,2790
109,12,663,永和區,永福里,18,1144,1315,1466,2781
109,12,664,蘆洲區,民和里　,15,1052,1375,1403,2778
109,12,665,板橋區,光華里,20,1138,1354,1423,2777
109,12,666,深坑區,萬福里,30,1244,1407,1361,2768
109,12,667,中和區,秀義里,18,1110,1362,1395,2757
109,12,668,板橋區,陽明里,17,1045,1330,1418,2748
109,12,669,三重區,國隆里,26,1124,1322,1420,2742
109,12,670,三重區,三安里,20,1235,1312,1426,2738
109,12,671,永和區,仁愛里,17,1178,1314,1424,2738
109,12,672,淡水區,義山里,19,1103,1460,1274,2734
109,12,673,新莊區,仁愛里,20,1055,1318,1404,2722
109,12,674,新莊區,自強里,15,1136,1353,1367,2720
109,12,675,三重區,光正里,22,1338,1310,1409,2719
109,12,676,新店區,大鵬里,10,1287,1305,1403,2708
109,12,677,新莊區,立德里,17,1022,1308,1392,2700
109,12,678,蘆洲區,保和里　,15,991,1317,1371,2688
109,12,679,永和區,大新里,16,1216,1197,1479,2676
109,12,680,板橋區,民權里,24,1091,1283,1390,2673
109,12,681,永和區,信義里,15,1231,1196,1465,2661
109,12,682,板橋區,光榮里,20,1043,1348,1310,2658
109,12,683,板橋區,東安里,11,897,1305,1348,2653
109,12,684,板橋區,華貴里,19,1006,1254,1396,2650
109,12,685,三重區,頂崁里,28,1071,1334,1306,2640
109,12,686,新莊區,福營里,20,1155,1309,1324,2633
109,12,687,新店區,國校里,10,1132,1290,1335,2625
109,12,688,新莊區,泰豐里,14,1050,1268,1352,2620
109,12,689,三重區,慈化里,17,955,1269,1349,2618
109,12,690,五股區,陸一里,35,1103,1281,1330,2611
109,12,691,板橋區,香雅里,11,1040,1272,1334,2606
109,12,692,新店區,長春里,11,1139,1193,1396,2589
109,12,693,深坑區,萬順里,24,1109,1289,1296,2585
109,12,694,三重區,永煇里,16,973,1316,1259,2575
109,12,695,新莊區,祥鳳里,18,929,1280,1292,2572
109,12,696,蘆洲區,忠孝里　,12,857,1249,1298,2547
109,12,697,新莊區,自信里,12,969,1220,1321,2541
109,12,698,永和區,頂溪里,16,1088,1186,1349,2535
109,12,699,新莊區,建福里,13,908,1258,1275,2533
109,12,700,新店區,忠誠里,20,1111,1232,1300,2532
109,12,701,三重區,長元里,18,1041,1283,1243,2526
109,12,702,新店區,文明里,18,1071,1211,1315,2526
109,12,703,板橋區,嵐翠里,12,979,1248,1271,2519
109,12,704,中和區,瑞穗里,18,1003,1169,1350,2519
109,12,705,中和區,秀士里,22,1088,1203,1312,2515
109,12,706,中和區,民享里,20,928,1228,1286,2514
109,12,707,新店區,屈尺里,18,905,1283,1226,2509
109,12,708,三重區,瑞德里,19,938,1229,1257,2486
109,12,709,永和區,永樂里,16,1114,1118,1367,2485
109,12,710,八里區,頂罟里,13,1007,1235,1237,2472
109,12,711,中和區,連和里,26,1255,1114,1347,2461
109,12,712,三峽區,溪北里,20,900,1288,1165,2453
109,12,713,中和區,壽南里,23,998,1208,1237,2445
109,12,714,新莊區,龍安里,15,849,1175,1243,2418
109,12,715,永和區,復興里,14,1026,1169,1246,2415
109,12,716,三峽區,嘉添里,21,811,1366,1040,2406
109,12,717,深坑區,賴仲里,26,1067,1218,1179,2397
109,12,718,三重區,錦江里,20,946,1186,1205,2391
109,12,719,板橋區,民生里,14,942,1140,1236,2376
109,12,720,新莊區,富國里,14,915,1196,1177,2373
109,12,721,汐止區,鄉長里,15,921,1181,1174,2355
109,12,722,新店區,張南里,10,1242,1023,1327,2350
109,12,723,三重區,文化里,28,947,1173,1174,2347
109,12,724,板橋區,富貴里,10,886,1138,1202,2340
109,12,725,三重區,菜寮里,19,940,1126,1213,2339
109,12,726,三重區,順德里,23,896,1185,1149,2334
109,12,727,石門區,老梅里,19,839,1196,1135,2331
109,12,728,中和區,錦昌里,13,970,1179,1150,2329
109,12,729,三重區,福利里,16,1035,1067,1249,2316
109,12,730,三重區,慈生里,20,884,1139,1172,2311
109,12,731,鶯歌區,西鶯里,18,883,1144,1166,2310
109,12,732,三重區,慈惠里,15,925,1154,1155,2309
109,12,733,樹林區,北園里,12,785,1212,1091,2303
109,12,734,板橋區,松柏里,12,938,1121,1179,2300
109,12,735,三重區,慈福里,17,952,1162,1134,2296
109,12,736,三重區,光華里,17,1074,1076,1201,2277
109,12,737,新莊區,龍福里,13,861,1084,1192,2276
109,12,738,三重區,長泰里,20,950,1137,1136,2273
109,12,739,永和區,新廍里,18,1002,1118,1153,2271
109,12,740,新莊區,文衡里,16,877,1114,1151,2265
109,12,741,淡水區,水源里,22,885,1187,1065,2252
109,12,742,新莊區,中誠里,15,885,1115,1137,2252
109,12,743,板橋區,民安里,19,878,1049,1198,2247
109,12,744,三重區,長安里,22,903,1098,1148,2246
109,12,745,瑞芳區,龍興里,13,967,1096,1133,2229
109,12,746,永和區,正興里,17,1003,1026,1197,2223
109,12,747,新莊區,營盤里,19,914,1112,1108,2220
109,12,748,泰山區,泰友里,18,789,1080,1140,2220
109,12,749,三芝區,後厝里,27,1158,1114,1088,2202
109,12,750,樹林區,三龍里,16,789,1130,1066,2196
109,12,751,汐止區,樟樹里,14,953,1145,1050,2195
109,12,752,土城區,土城里,19,897,1063,1129,2192
109,12,753,三重區,錦田里,15,876,1088,1102,2190
109,12,754,貢寮區,真理里,22,729,1073,1116,2189
109,12,755,瑞芳區,傑魚里,10,800,1142,1047,2189
109,12,756,三重區,富福里,20,814,1050,1135,2185
109,12,757,蘆洲區,仁復里　,11,858,1085,1098,2183
109,12,758,深坑區,昇高里,16,795,1136,1046,2182
109,12,759,瑞芳區,瑞濱里,13,1086,1063,1119,2182
109,12,760,永和區,前溪里,13,988,1007,1164,2171
109,12,761,土城區,長風里,14,825,1035,1121,2156
109,12,762,中和區,景本里,22,897,1043,1113,2156
109,12,763,板橋區,新埔里,13,886,1043,1095,2138
109,12,764,樹林區,樂山里,15,750,1084,1047,2131
109,12,765,三重區,安慶里,16,898,996,1117,2113
109,12,766,板橋區,華福里,13,779,1018,1087,2105
109,12,767,三重區,長江里,17,889,1029,1061,2090
109,12,768,三峽區,竹崙里,20,901,1161,923,2084
109,12,769,新店區,仁愛里,19,966,973,1107,2080
109,12,770,三重區,信安里,18,914,1003,1072,2075
109,12,771,三重區,正安里,16,847,984,1066,2050
109,12,772,三重區,大同里,17,936,987,1061,2048
109,12,773,新莊區,立人里,9,771,1003,1037,2040
109,12,774,三重區,萬壽里,20,817,985,1049,2034
109,12,775,板橋區,挹秀里,13,871,979,1030,2009
109,12,776,三重區,仁德里,20,899,1002,1006,2008
109,12,777,三重區,永春里,14,805,975,1029,2004
109,12,778,永和區,後溪里,13,870,981,1022,2003
109,12,779,八里區,荖阡里,12,637,1012,942,1954
109,12,780,三重區,龍門里,20,797,962,984,1946
109,12,781,三重區,五谷里,25,858,986,951,1937
109,12,782,金山區,磺港里,20,565,980,955,1935
109,12,783,永和區,上溪里,20,905,890,1035,1925
109,12,784,中和區,宜安里,17,848,919,986,1905
109,12,785,三重區,中央里,19,871,925,975,1900
109,12,786,金山區,五湖里,17,625,967,929,1896
109,12,787,淡水區,埤島里,13,842,1019,876,1895
109,12,788,烏來區,忠治里,7,561,919,967,1886
109,12,789,樹林區,西園里,14,654,1005,878,1883
109,12,790,三重區,正義里,14,774,952,927,1879
109,12,791,貢寮區,仁里里,16,672,935,942,1877
109,12,792,瑞芳區,東和里,14,714,923,951,1874
109,12,793,三重區,忠孝里,19,781,914,959,1873
109,12,794,淡水區,文化里,14,811,864,1005,1869
109,12,795,三重區,錦安里,22,784,884,984,1868
109,12,796,新莊區,文德里,18,737,916,950,1866
109,12,797,三重區,自強里,16,770,897,968,1865
109,12,798,三重區,承德里,20,655,945,915,1860
109,12,799,瑞芳區,吉慶里,18,719,977,875,1852
109,12,800,瑞芳區,龍川里,11,733,893,948,1841
109,12,801,新莊區,文明里,16,678,899,939,1838
109,12,802,汐止區,仁德里,17,835,887,947,1834
109,12,803,新店區,新店里,16,837,903,930,1833
109,12,804,八里區,長坑里,14,502,964,852,1816
109,12,805,新店區,文中里,14,820,879,926,1805
109,12,806,三重區,同慶里,17,749,884,920,1804
109,12,807,樹林區,東園里,14,697,970,833,1803
109,12,808,永和區,光復里,16,792,820,981,1801
109,12,809,八里區,下罟里,12,558,900,897,1797
109,12,810,新店區,龜山里,13,737,903,890,1793
109,12,811,三重區,奕壽里,15,777,872,915,1787
109,12,812,林口區,太平里,15,668,880,903,1783
109,12,813,樹林區,坡內里,15,603,901,868,1769
109,12,814,貢寮區,福隆里,22,650,869,895,1764
109,12,815,石門區,石門里,14,677,897,852,1749
109,12,816,新店區,頂城里,18,722,916,826,1742
109,12,817,土城區,祖田里,10,607,894,839,1733
109,12,818,鶯歌區,同慶里,14,627,841,879,1720
109,12,819,三重區,大安里,15,683,857,858,1715
109,12,820,板橋區,留侯里,10,694,810,886,1696
109,12,821,汐止區,保安里,15,660,850,839,1689
109,12,822,石門區,尖鹿里,16,636,885,792,1677
109,12,823,汐止區,長安里,15,687,819,853,1672
109,12,824,淡水區,興仁里,14,686,894,765,1659
109,12,825,三重區,二重里,15,589,836,820,1656
109,12,826,土城區,清化里,17,627,881,767,1648
109,12,827,淡水區,賢孝里,14,654,882,760,1642
109,12,828,林口區,湖北里,14,494,872,750,1622
109,12,829,樹林區,圳生里,11,584,849,772,1621
109,12,830,雙溪區,牡丹里,38,706,852,758,1610
109,12,831,汐止區,烘內里,21,777,848,762,1610
109,12,832,三峽區,溪南里,16,560,886,708,1594
109,12,833,三重區,長福里,20,658,764,822,1586
109,12,834,三重區,開元里,20,689,775,767,1542
109,12,835,新莊區,國泰里,16,550,763,779,1542
109,12,836,三重區,光輝里,18,622,762,778,1540
109,12,837,三重區,平和里,18,635,781,752,1533
109,12,838,三重區,重新里,19,665,748,781,1529
109,12,839,坪林區,坪林里,12,497,811,717,1528
109,12,840,板橋區,流芳里,10,635,707,811,1518
109,12,841,淡水區,協元里,10,619,753,763,1516
109,12,842,三重區,錦通里,16,650,730,783,1513
109,12,843,石門區,富基里,15,543,733,774,1507
109,12,844,三重區,同安里,19,607,750,743,1493
109,12,845,淡水區,樹興里,12,729,764,725,1489
109,12,846,瑞芳區,龍山里,11,594,784,692,1476
109,12,847,三重區,光榮里,17,667,713,755,1468
109,12,848,淡水區,長庚里,29,652,715,753,1468
109,12,849,三峽區,安坑里,16,578,821,639,1460
109,12,850,瑞芳區,上天里,12,551,784,674,1458
109,12,851,瑞芳區,深澳里,15,695,685,762,1447
109,12,852,林口區,下福里,20,493,740,698,1438
109,12,853,五股區,五龍里,17,479,799,638,1437
109,12,854,三重區,吉利里,12,641,707,723,1430
109,12,855,新店區,廣興里,17,606,771,647,1418
109,12,856,五股區,觀音里,17,533,780,638,1418
109,12,857,三重區,中正里,13,579,694,719,1413
109,12,858,三重區,永興里,17,668,651,755,1406
109,12,859,板橋區,福翠里,16,577,707,693,1400
109,12,860,淡水區,坪頂里,10,635,696,698,1394
109,12,861,汐止區,義民里,20,632,667,708,1375
109,12,862,三重區,秀江里,15,528,670,675,1345
109,12,863,瑞芳區,海濱里,13,679,637,702,1339
109,12,864,瑞芳區,龍鎮里,15,572,657,671,1328
109,12,865,新店區,直潭里,22,481,690,624,1314
109,12,866,坪林區,大林里,10,482,724,578,1302
109,12,867,新店區,和平里,11,573,640,660,1300
109,12,868,三重區,中民里,17,525,660,637,1297
109,12,869,三重區,仁義里,17,530,646,647,1293
109,12,870,金山區,重和里,13,552,643,638,1281
109,12,871,板橋區,黃石里,10,523,615,666,1281
109,12,872,板橋區,歡園里,8,477,661,618,1279
109,12,873,三芝區,興華里,20,541,693,583,1276
109,12,874,萬里區,中幅里,13,374,627,649,1276
109,12,875,永和區,勵行里,17,586,597,675,1272
109,12,876,汐止區,環河里,10,546,680,590,1270
109,12,877,雙溪區,泰平里,20,415,636,624,1260
109,12,878,石門區,德茂里,14,447,665,589,1254
109,12,879,樹林區,樹東里,16,552,596,643,1239
109,12,880,三重區,介壽里,13,520,602,633,1235
109,12,881,五股區,更寮里,11,438,650,573,1223
109,12,882,永和區,網溪里,12,503,609,613,1222
109,12,883,三重區,福星里,17,600,567,651,1218
109,12,884,淡水區,忠寮里,13,442,688,529,1217
109,12,885,瑞芳區,柑坪里,16,433,633,582,1215
109,12,886,淡水區,清文里,25,499,626,589,1215
109,12,887,三峽區,弘道里,14,415,678,528,1206
109,12,888,三芝區,古庄里,19,592,631,575,1206
109,12,889,三重區,正德里,16,513,591,595,1186
109,12,890,林口區,頂福里,20,416,639,533,1172
109,12,891,三峽區,添福里,9,435,622,546,1168
109,12,892,鶯歌區,中鶯里,16,412,558,573,1131
109,12,893,淡水區,屯山里,13,361,604,522,1126
109,12,894,汐止區,禮門里,17,522,553,573,1126
109,12,895,鶯歌區,東鶯里,14,420,564,546,1110
109,12,896,淡水區,蕃薯里,10,513,631,474,1105
109,12,897,石碇區,格頭里,13,529,570,519,1089
109,12,898,萬里區,雙興里,15,398,589,488,1077
109,12,899,新店區,塗潭里,11,357,565,509,1074
109,12,900,林口區,嘉寶里,20,372,580,486,1066
109,12,901,貢寮區,和美里,21,357,540,507,1047
109,12,902,石門區,草里里,12,377,533,510,1043
109,12,903,汐止區,八連里,10,461,548,484,1032
109,12,904,板橋區,復興里,8,291,621,395,1016
109,12,905,板橋區,赤松里,8,456,459,537,996
109,12,906,永和區,永成里,19,421,481,511,992
109,12,907,三重區,谷王里,15,380,523,465,988
109,12,908,三峽區,成福里,16,331,532,456,988
109,12,909,雙溪區,平林里,14,446,539,444,983
109,12,910,永和區,大同里,18,457,501,482,983
109,12,911,鶯歌區,二甲里,8,336,528,453,981
109,12,912,三重區,雙園里,13,414,472,499,971
109,12,913,泰山區,大科里,16,334,520,434,954
109,12,914,樹林區,樹北里,18,437,470,482,952
109,12,915,汐止區,長青里,10,549,445,505,950
109,12,916,石門區,山溪里,16,360,530,418,948
109,12,917,坪林區,粗窟里,11,361,522,414,936
109,12,918,石碇區,永安里,6,398,479,456,935
109,12,919,瑞芳區,鼻頭里,11,261,463,467,930
109,12,920,淡水區,永吉里,22,405,452,469,921
109,12,921,貢寮區,福連里,16,302,419,501,920
109,12,922,林口區,瑞平里,10,327,508,411,919
109,12,923,淡水區,忠山里,10,361,503,412,915
109,12,924,三重區,長生里,10,392,447,467,914
109,12,925,坪林區,上德里,13,337,515,391,906
109,12,926,貢寮區,貢寮里,16,375,453,450,903
109,12,927,金山區,清泉里,10,293,487,415,902
109,12,928,三峽區,五寮里,15,365,487,411,898
109,12,929,坪林區,漁光里,13,393,471,419,890
109,12,930,三重區,大德里,11,362,416,468,884
109,12,931,平溪區,十分里,10,435,481,395,876
109,12,932,石碇區,潭邊里,10,417,457,412,869
109,12,933,新店區,廣明里,13,422,426,438,864
109,12,934,三芝區,福德里,18,366,440,420,860
109,12,935,三芝區,新庄里,12,350,450,403,853
109,12,936,永和區,新生里,18,389,421,420,841
109,12,937,中和區,灰磘里,7,255,447,384,831
109,12,938,新店區,雙坑里,15,314,458,364,822
109,12,939,烏來區,福山里,6,216,408,412,820
109,12,940,雙溪區,新基里,17,357,436,381,817
109,12,941,石碇區,中民里,14,345,467,338,805
109,12,942,永和區,忠義里,16,300,407,396,803
109,12,943,瑞芳區,龍潭里,13,363,394,409,803
109,12,944,金山區,大同里,9,284,377,420,797
109,12,945,淡水區,草東里,24,338,393,377,770
109,12,946,貢寮區,美豐里,21,304,450,318,768
109,12,947,雙溪區,魚行里,29,355,421,329,750
109,12,948,石碇區,隆盛里,12,299,414,326,740
109,12,949,三峽區,有木里,14,361,445,295,740
109,12,950,淡水區,民安里,24,292,352,386,738
109,12,951,三芝區,錫板里,17,298,419,302,721
109,12,952,金山區,六股里,8,237,386,329,715
109,12,953,萬里區,溪底里,9,289,384,322,706
109,12,954,貢寮區,龍門里,14,249,342,358,700
109,12,955,三峽區,秀川里,10,286,336,358,694
109,12,956,三峽區,插角里,16,363,411,282,693
109,12,957,貢寮區,雙玉里,23,290,394,297,691
109,12,958,坪林區,水德里,10,282,365,325,690
109,12,959,瑞芳區,龍安里,11,279,347,338,685
109,12,960,金山區,三界里,10,207,318,366,684
109,12,961,石碇區,永定里,10,276,364,310,674
109,12,962,三芝區,茂長里,9,298,348,320,668
109,12,963,雙溪區,上林里,20,299,379,282,661
109,12,964,石碇區,烏塗里,10,332,385,274,659
109,12,965,萬里區,磺潭里,14,237,358,301,659
109,12,966,石門區,茂林里,11,215,347,298,645
109,12,967,平溪區,嶺腳里,10,301,347,292,639
109,12,968,汐止區,東山里,20,289,331,307,638
109,12,969,三芝區,店子里,14,254,347,282,629
109,12,970,深坑區,阿柔里,9,228,347,281,628
109,12,971,金山區,永興里,15,238,335,291,626
109,12,972,淡水區,中和里,11,218,356,266,622
109,12,973,鶯歌區,建德里,8,213,340,278,618
109,12,974,烏來區,信賢里,9,195,282,320,602
109,12,975,三芝區,圓山里,12,215,335,256,591
109,12,976,金山區,豐漁里,9,169,288,278,566
109,12,977,三峽區,金圳里,12,230,314,221,535
109,12,978,三芝區,橫山里,19,226,304,223,527
109,12,979,金山區,萬壽里,8,185,245,265,510
109,12,980,金山區,和平里,8,187,245,260,505
109,12,981,瑞芳區,濂洞里,20,251,238,263,501
109,12,982,雙溪區,雙溪里,19,222,244,246,490
109,12,983,貢寮區,吉林里,19,247,304,186,490
109,12,984,瑞芳區,猴硐里,12,201,275,207,482
109,12,985,瑞芳區,永慶里,13,232,247,216,463
109,12,986,平溪區,石底里,10,217,242,218,460
109,12,987,瑞芳區,基山里,15,216,232,222,454
109,12,988,萬里區,崁脚里,14,173,231,221,452
109,12,989,坪林區,石𥕢里,9,195,241,210,451
109,12,990,淡水區,新生里,13,231,197,246,443
109,12,991,平溪區,東勢里,10,246,256,180,436
109,12,992,貢寮區,龍崗里,12,183,246,187,433
109,12,993,石碇區,豐田里,7,214,249,180,429
109,12,994,石碇區,石碇里,9,172,224,197,421
109,12,995,金山區,兩湖里,7,134,222,196,418
109,12,996,雙溪區,外柑里,17,216,243,165,408
109,12,997,平溪區,薯榔里,10,202,222,173,395
109,12,998,雙溪區,共和里,13,186,208,185,393
109,12,999,雙溪區,長源里,20,192,221,157,378
109,12,1000,雙溪區,三港里,17,182,224,153,377
109,12,1001,三重區,德厚里,6,171,178,198,376
109,12,1002,瑞芳區,新山里,11,180,201,167,368
109,12,1003,平溪區,南山里,9,193,218,138,356
109,12,1004,瑞芳區,頌德里,10,179,186,169,355
109,12,1005,汐止區,信望里,14,161,186,168,354
109,12,1006,瑞芳區,石山里,13,183,185,158,343
109,12,1007,雙溪區,三貂里,20,155,189,152,341
109,12,1008,石碇區,豐林里,5,118,181,158,339
109,12,1009,三芝區,八賢里,10,137,187,150,337
109,12,1010,三峽區,三峽里,10,126,191,142,333
109,12,1011,中和區,橫路里,7,128,168,160,328
109,12,1012,石門區,乾華里,7,145,187,139,326
109,12,1013,石碇區,彭山里,6,157,180,142,322
109,12,1014,瑞芳區,濂新里,10,130,149,171,320
109,12,1015,瑞芳區,崇文里,10,163,166,149,315
109,12,1016,石碇區,光明里,5,145,160,123,283
109,12,1017,平溪區,平溪里,10,135,155,126,281
109,12,1018,瑞芳區,弓橋里,8,131,161,117,278
109,12,1019,瑞芳區,南雅里,9,94,138,135,273
109,12,1020,鶯歌區,東湖里,10,133,152,121,273
109,12,1021,瑞芳區,光復里,14,135,148,119,267
109,12,1022,平溪區,白石里,13,117,140,114,254
109,12,1023,烏來區,孝義里,6,44,128,115,243
109,12,1024,平溪區,菁桐里,11,124,132,110,242
109,12,1025,瑞芳區,銅山里,12,100,106,88,194
109,12,1026,金山區,西湖里,7,57,108,75,183
109,12,1027,瑞芳區,福住里,8,96,94,84,178
109,12,1028,瑞芳區,瓜山里,11,101,90,86,176
109,12,1029,平溪區,平湖里,10,87,91,80,171
109,12,1030,平溪區,新寮里,9,94,99,61,160
109,12,1031,平溪區,望古里,8,101,90,64,154
109,12,1032,瑞芳區,碩仁里,10,75,81,58,139
總計,,,,,22376,1606814,1968355,2062599,4030954