年,月,排名,隸屬區,里,鄰數,戶數,男,女,合計
110,11,1,林口區,南勢里,40,12597,13213,14578,27791
110,11,2,林口區,湖南里,48,11871,13288,14473,27761
110,11,3,淡水區,崁頂里,15,11239,10709,11490,22199
110,11,4,三峽區,龍學里,45,7136,7829,9013,16842
110,11,5,樹林區,南園里,52,6709,7785,8389,16174
110,11,6,蘆洲區,正義里　,25,5787,7436,8099,15535
110,11,7,板橋區,溪福里,46,5198,7283,7521,14804
110,11,8,新店區,公崙里,37,5614,6723,7205,13928
110,11,9,新莊區,中原里,33,5756,6590,7216,13806
110,11,10,新莊區,西盛里,29,5103,6494,6740,13234
110,11,11,新莊區,立廷里,40,5112,6167,6964,13131
110,11,12,新莊區,雙鳳里,36,4790,6182,6339,12521
110,11,13,林口區,西林里,37,4703,5905,5948,11853
110,11,14,五股區,成泰里,34,5213,5813,5792,11605
110,11,15,淡水區,北投里,22,5098,5462,6099,11561
110,11,16,新店區,香坡里,46,5145,5625,5875,11500
110,11,17,淡水區,竿蓁里,26,6013,5197,6175,11372
110,11,18,蘆洲區,水湳里　,25,3929,5333,5582,10915
110,11,19,板橋區,忠翠里,28,4526,5091,5823,10914
110,11,20,新莊區,龍鳳里,30,4377,5133,5766,10899
110,11,21,永和區,保順里,38,4582,5016,5783,10799
110,11,22,淡水區,大庄里,12,5398,4940,5769,10709
110,11,23,三峽區,鳶山里,28,4058,5258,5358,10616
110,11,24,三峽區,龍埔里,36,4069,5239,5349,10588
110,11,25,樹林區,柑園里,37,4303,5010,5353,10363
110,11,26,新莊區,頭前里,16,4753,5025,5318,10343
110,11,27,板橋區,崑崙里,36,3767,5012,5247,10259
110,11,28,泰山區,全興里,25,3882,4853,5114,9967
110,11,29,新莊區,中平里,23,3724,4585,5341,9926
110,11,30,三重區,過田里,28,5483,5427,4393,9820
110,11,31,蘆洲區,水河里　,18,3478,4807,4992,9799
110,11,32,板橋區,社後里,28,5615,5572,4225,9797
110,11,33,林口區,麗林里,32,3842,4632,5155,9787
110,11,34,淡水區,新春里,15,3947,4666,5052,9718
110,11,35,新店區,柴埕里,34,3771,4581,4852,9433
110,11,36,鶯歌區,尖山里,16,3572,4705,4678,9383
110,11,37,新莊區,丹鳳里,28,3616,4548,4833,9381
110,11,38,中和區,平河里,67,3813,4449,4848,9297
110,11,39,新店區,張北里,32,4182,4380,4905,9285
110,11,40,板橋區,深丘里,32,3734,4437,4789,9226
110,11,41,新莊區,中信里,34,3211,4476,4731,9207
110,11,42,新莊區,昌平里,21,4140,4189,4817,9006
110,11,43,三重區,溪美里,31,3635,4336,4619,8955
110,11,44,板橋區,重慶里,38,3312,4276,4572,8848
110,11,45,三重區,碧華里,16,3923,4224,4616,8840
110,11,46,鶯歌區,永昌里,22,2899,4366,4460,8826
110,11,47,鶯歌區,二橋里,26,3152,4488,4304,8792
110,11,48,土城區,永寧里,37,3257,4364,4365,8729
110,11,49,泰山區,義仁里,39,3243,4288,4418,8706
110,11,50,土城區,埤林里,38,3174,4167,4465,8632
110,11,51,中和區,積穗里,45,3484,4061,4304,8365
110,11,52,板橋區,新翠里,29,3289,3954,4373,8327
110,11,53,汐止區,忠孝里,38,3874,4003,4320,8323
110,11,54,五股區,水碓里,36,3048,4109,4151,8260
110,11,55,新店區,安和里,28,3381,3998,4220,8218
110,11,56,板橋區,海山里,23,2816,3896,4320,8216
110,11,57,土城區,清水里,32,2962,4034,4176,8210
110,11,58,中和區,新南里,49,3566,3767,4422,8189
110,11,59,中和區,中原里,24,3792,3969,4161,8130
110,11,60,五股區,成功里,34,3541,3955,4092,8047
110,11,61,林口區,東勢里,42,2917,3890,4125,8015
110,11,62,板橋區,華東里,32,3561,3870,4143,8013
110,11,63,蘆洲區,成功里　,29,2658,3853,4135,7988
110,11,64,汐止區,中興里,32,3676,3872,4073,7945
110,11,65,中和區,華新里,48,3269,3805,4126,7931
110,11,66,板橋區,華江里,30,3270,3659,4239,7898
110,11,67,淡水區,新興里,9,3379,3635,4232,7867
110,11,68,新店區,五峯里,25,3479,3612,4153,7765
110,11,69,三峽區,龍恩里,31,3281,3695,4065,7760
110,11,70,三峽區,安溪里,38,2814,3793,3939,7732
110,11,71,三峽區,永舘里,25,2859,3715,4006,7721
110,11,72,三重區,光明里,30,3092,3749,3960,7709
110,11,73,汐止區,厚德里,30,3188,3801,3877,7678
110,11,74,新莊區,光華里,28,2716,3779,3871,7650
110,11,75,土城區,員林里,34,3207,3646,3974,7620
110,11,76,土城區,峯廷里,31,2678,3800,3804,7604
110,11,77,鶯歌區,建國里,34,2752,3661,3934,7595
110,11,78,八里區,舊城里,22,3026,3693,3885,7578
110,11,79,林口區,仁愛里,30,2997,3586,3946,7532
110,11,80,中和區,外南里,31,4364,4182,3330,7512
110,11,81,新店區,中興里,18,4221,3922,3567,7489
110,11,82,板橋區,福安里,25,3434,3599,3890,7489
110,11,83,板橋區,成和里,24,2861,3662,3812,7474
110,11,84,八里區,龍源里,30,3297,3613,3843,7456
110,11,85,板橋區,德翠里,26,2725,3624,3774,7398
110,11,86,新店區,寶福里,29,3297,3567,3820,7387
110,11,87,淡水區,民生里,32,3563,3308,4014,7322
110,11,88,汐止區,復興里,24,3349,3401,3910,7311
110,11,89,汐止區,福安里,16,2896,3498,3786,7284
110,11,90,新莊區,裕民里,32,2656,3592,3682,7274
110,11,91,新莊區,後港里,31,2606,3529,3703,7232
110,11,92,板橋區,溪頭里,25,3203,3492,3713,7205
110,11,93,土城區,平和里,34,2476,3491,3701,7192
110,11,94,板橋區,華德里,32,3000,3433,3751,7184
110,11,95,永和區,保安里,34,2934,3410,3762,7172
110,11,96,板橋區,中山里,32,3139,3507,3655,7162
110,11,97,淡水區,福德里,19,3537,3428,3732,7160
110,11,98,土城區,日和里,31,2845,3456,3653,7109
110,11,99,蘆洲區,永康里　,22,2482,3395,3707,7102
110,11,100,泰山區,山腳里,45,2565,3561,3538,7099
110,11,101,三芝區,埔坪里,35,2951,3552,3532,7084
110,11,102,三峽區,介壽里,28,2790,3603,3428,7031
110,11,103,土城區,延和里,32,2686,3348,3646,6994
110,11,104,中和區,員山里,42,2848,3379,3611,6990
110,11,105,中和區,中興里,38,2824,3346,3636,6982
110,11,106,土城區,清溪里,53,2665,3388,3557,6945
110,11,107,板橋區,廣德里,25,2629,3392,3539,6931
110,11,108,新莊區,建安里,34,2558,3305,3560,6865
110,11,109,蘆洲區,樓厝里　,24,2668,3323,3540,6863
110,11,110,三重區,富貴里,32,2946,3284,3505,6789
110,11,111,淡水區,八勢里,14,3722,3095,3691,6786
110,11,112,中和區,德行里,42,2844,3212,3545,6757
110,11,113,三重區,成功里,21,2943,3210,3533,6743
110,11,114,蘆洲區,永樂里　,27,2255,3302,3330,6632
110,11,115,新莊區,中港里,28,2252,3193,3429,6622
110,11,116,汐止區,湖興里,38,3027,3283,3287,6570
110,11,117,三重區,田中里,30,2369,3187,3348,6535
110,11,118,深坑區,埔新里,57,2681,3158,3366,6524
110,11,119,土城區,清和里,28,2360,3240,3269,6509
110,11,120,中和區,連城里,48,2645,3102,3398,6500
110,11,121,新店區,信義里,31,3176,3070,3428,6498
110,11,122,五股區,成州里,27,2413,3276,3216,6492
110,11,123,新莊區,中美里,24,2458,3075,3313,6388
110,11,124,中和區,秀景里,43,2883,3052,3322,6374
110,11,125,蘆洲區,中原里　,29,2318,3089,3274,6363
110,11,126,蘆洲區,恆德里　,21,2601,3026,3323,6349
110,11,127,樹林區,保安里,34,2326,3145,3191,6336
110,11,128,三重區,光陽里,33,2661,3144,3188,6332
110,11,129,淡水區,鄧公里,17,2674,2954,3369,6323
110,11,130,板橋區,埔墘里,23,2608,2996,3326,6322
110,11,131,蘆洲區,南港里　,20,2099,3065,3233,6298
110,11,132,三重區,田安里,42,2428,3032,3266,6298
110,11,133,淡水區,竹圍里,15,3005,2860,3428,6288
110,11,134,三峽區,礁溪里,37,2420,3045,3232,6277
110,11,135,汐止區,湖光里,30,3057,2969,3293,6262
110,11,136,新店區,德安里,28,2317,3106,3155,6261
110,11,137,汐止區,江北里,30,2583,3206,3035,6241
110,11,138,新莊區,立基里,32,2342,3050,3191,6241
110,11,139,土城區,金城里,26,2401,2946,3293,6239
110,11,140,樹林區,東陽里,31,2268,3095,3138,6233
110,11,141,板橋區,懷翠里,26,2269,3074,3136,6210
110,11,142,鶯歌區,鳳鳴里,29,2494,3078,3124,6202
110,11,143,蘆洲區,玉清里　,21,2400,3013,3188,6201
110,11,144,新莊區,民安里,33,2160,3003,3197,6200
110,11,145,新莊區,福興里,17,2260,3108,3076,6184
110,11,146,汐止區,自強里,25,2656,2935,3242,6177
110,11,147,新店區,中正里,24,2651,2847,3325,6172
110,11,148,中和區,力行里,45,2454,2941,3198,6139
110,11,149,三重區,永豐里,32,2159,2986,3145,6131
110,11,150,板橋區,溪洲里,21,2224,2987,3137,6124
110,11,151,新店區,玫瑰里,28,2358,2919,3174,6093
110,11,152,板橋區,港嘴里,25,2406,2954,3086,6040
110,11,153,樹林區,山佳里,21,2009,3052,2976,6028
110,11,154,土城區,明德里,30,2445,2790,3226,6016
110,11,155,三重區,永發里,27,2202,2985,3028,6013
110,11,156,三重區,六福里,29,2086,2959,3033,5992
110,11,157,淡水區,水碓里,20,2311,2898,3084,5982
110,11,158,樹林區,彭興里,41,2112,2987,2991,5978
110,11,159,新店區,日興里,29,2312,2976,2970,5946
110,11,160,中和區,安平里,43,2728,2811,3101,5912
110,11,161,新店區,中央里,20,2723,2754,3141,5895
110,11,162,鶯歌區,南鶯里,34,2174,2856,3034,5890
110,11,163,新店區,雙城里,29,2224,2993,2879,5872
110,11,164,三重區,福祉里,20,2444,2836,3035,5871
110,11,165,板橋區,中正里,27,2509,2838,3031,5869
110,11,166,鶯歌區,中湖里,27,2056,3025,2839,5864
110,11,167,汐止區,北山里,25,2735,2773,3069,5842
110,11,168,土城區,廣福里,33,2093,2872,2965,5837
110,11,169,新店區,永平里,17,2190,2808,3012,5820
110,11,170,土城區,永富里,27,2172,2828,2937,5765
110,11,171,中和區,景福里,44,2666,2711,3053,5764
110,11,172,新店區,新生里,26,2591,2690,3069,5759
110,11,173,汐止區,秀峰里,23,2826,3047,2694,5741
110,11,174,土城區,員仁里,33,2068,2806,2919,5725
110,11,175,蘆洲區,仁德里　,20,2015,2836,2884,5720
110,11,176,新莊區,榮和里,25,3369,3313,2386,5699
110,11,177,樹林區,彭福里,33,2151,2818,2876,5694
110,11,178,林口區,林口里,29,2198,2789,2903,5692
110,11,179,蘆洲區,鷺江里　,21,2099,2782,2879,5661
110,11,180,中和區,錦和里,21,2047,2780,2871,5651
110,11,181,土城區,裕生里,39,2155,2727,2923,5650
110,11,182,汐止區,新昌里,35,2367,2725,2921,5646
110,11,183,新店區,安昌里,17,2429,2636,2996,5632
110,11,184,淡水區,油車里,20,2411,2737,2891,5628
110,11,185,板橋區,玉光里,21,2247,2650,2978,5628
110,11,186,金山區,金美里,35,2043,2659,2958,5617
110,11,187,三重區,永清里,32,2008,2703,2913,5616
110,11,188,中和區,瓦磘里,29,2297,2685,2930,5615
110,11,189,蘆洲區,九芎里　,27,1979,2728,2883,5611
110,11,190,土城區,埤塘里,17,2986,3258,2336,5594
110,11,191,土城區,頂福里,25,2145,2775,2803,5578
110,11,192,新莊區,瓊林里,20,1997,2829,2747,5576
110,11,193,板橋區,宏翠里,21,2539,2612,2963,5575
110,11,194,土城區,員福里,28,2093,2800,2764,5564
110,11,195,板橋區,純翠里,16,2144,2635,2912,5547
110,11,196,三芝區,埔頭里,42,2225,2721,2811,5532
110,11,197,新莊區,海山里,24,2174,2690,2840,5530
110,11,198,新莊區,思源里,22,2124,2691,2825,5516
110,11,199,新莊區,信義里,25,2102,2636,2879,5515
110,11,200,五股區,德音里,30,2046,2725,2786,5511
110,11,201,樹林區,中山里,25,1919,2809,2701,5510
110,11,202,蘆洲區,仁義里　,18,2809,2999,2511,5510
110,11,203,新莊區,福基里,17,2492,2716,2791,5507
110,11,204,新莊區,中隆里,27,2125,2635,2845,5480
110,11,205,三峽區,中正里,34,1813,2778,2694,5472
110,11,206,蘆洲區,光華里　,19,2035,2609,2863,5472
110,11,207,新店區,寶興里,24,2590,2567,2905,5472
110,11,208,汐止區,金龍里,41,2553,2623,2847,5470
110,11,209,新莊區,自立里,26,2209,2605,2863,5468
110,11,210,三重區,永福里,30,2009,2614,2834,5448
110,11,211,新店區,江陵里,23,2333,2547,2898,5445
110,11,212,新店區,青潭里,22,2292,2616,2825,5441
110,11,213,蘆洲區,永安里　,19,1909,2618,2823,5441
110,11,214,汐止區,建成里,23,2426,2517,2917,5434
110,11,215,中和區,景平里,43,2531,2504,2916,5420
110,11,216,板橋區,華中里,20,1980,2699,2712,5411
110,11,217,蘆洲區,仁愛里　,19,1875,2637,2759,5396
110,11,218,三重區,五華里,18,2145,2583,2809,5392
110,11,219,新莊區,忠孝里,29,2297,2580,2801,5381
110,11,220,三重區,大有里,25,2033,2674,2705,5379
110,11,221,新店區,寶安里,39,2599,2454,2909,5363
110,11,222,新店區,員潭里,19,2314,2615,2744,5359
110,11,223,蘆洲區,長安里　,19,1828,2657,2691,5348
110,11,224,板橋區,民族里,20,1943,2557,2785,5342
110,11,225,新莊區,南港里,22,1976,2602,2726,5328
110,11,226,汐止區,拱北里,31,2195,2704,2617,5321
110,11,227,板橋區,聚安里,28,1996,2655,2663,5318
110,11,228,樹林區,樹西里,32,2031,2640,2671,5311
110,11,229,中和區,民安里,25,2030,2615,2692,5307
110,11,230,三重區,永順里,36,1892,2551,2753,5304
110,11,231,汐止區,崇德里,29,2145,2613,2690,5303
110,11,232,樹林區,文林里,36,1910,2582,2715,5297
110,11,233,新莊區,成德里,23,1866,2573,2714,5287
110,11,234,新店區,美潭里,20,2175,2595,2692,5287
110,11,235,板橋區,湳興里,25,2261,2519,2741,5260
110,11,236,汐止區,康福里,24,2750,2450,2795,5245
110,11,237,新店區,永安里,25,2007,2537,2699,5236
110,11,238,新莊區,光明里,21,1741,2564,2671,5235
110,11,239,樹林區,東昇里,28,1945,2579,2655,5234
110,11,240,泰山區,貴和里,42,2014,2548,2674,5222
110,11,241,板橋區,江翠里,20,2118,2570,2644,5214
110,11,242,中和區,碧河里,27,2257,2541,2669,5210
110,11,243,中和區,文元里,35,2010,2533,2674,5207
110,11,244,板橋區,自強里,35,2068,2538,2651,5189
110,11,245,永和區,福和里,23,2320,2448,2733,5181
110,11,246,三重區,慈祐里,26,1949,2535,2641,5176
110,11,247,中和區,南山里,38,2205,2499,2670,5169
110,11,248,新莊區,立泰里,21,1938,2470,2692,5162
110,11,249,鶯歌區,永吉里,32,1675,2565,2597,5162
110,11,250,汐止區,北峰里,26,2248,2571,2586,5157
110,11,251,板橋區,福丘里,19,2288,2369,2784,5153
110,11,252,土城區,頂埔里,31,2046,2519,2629,5148
110,11,253,八里區,訊塘里,23,2112,2512,2623,5135
110,11,254,樹林區,獇寮里,27,1821,2565,2570,5135
110,11,255,樹林區,彭厝里,40,1739,2538,2595,5133
110,11,256,林口區,中湖里,17,2002,2550,2572,5122
110,11,257,鶯歌區,大湖里,24,1923,2580,2534,5114
110,11,258,新莊區,立言里,24,1882,2434,2677,5111
110,11,259,樹林區,潭底里,33,2229,2810,2301,5111
110,11,260,板橋區,福德里,28,1967,2537,2570,5107
110,11,261,永和區,中溪里,21,2101,2524,2579,5103
110,11,262,中和區,華南里,24,2108,2520,2580,5100
110,11,263,三重區,永德里,34,1914,2510,2589,5099
110,11,264,中和區,福祥里,38,2098,2495,2602,5097
110,11,265,土城區,樂利里,36,1948,2458,2638,5096
110,11,266,土城區,大安里,25,2035,2540,2555,5095
110,11,267,新莊區,全泰里,27,1927,2481,2594,5075
110,11,268,中和區,復興里,55,2050,2371,2699,5070
110,11,269,中和區,自強里,25,1914,2470,2586,5056
110,11,270,土城區,安和里,28,1842,2493,2562,5055
110,11,271,土城區,廷寮里,23,1753,2525,2516,5041
110,11,272,蘆洲區,光明里　,23,1792,2454,2583,5037
110,11,273,泰山區,義學里,27,1850,2503,2533,5036
110,11,274,土城區,學士里,27,1894,2433,2603,5036
110,11,275,汐止區,保長里,22,2171,2458,2566,5024
110,11,276,中和區,秀明里,56,2364,2296,2725,5021
110,11,277,中和區,內南里,39,1843,2511,2508,5019
110,11,278,板橋區,龍翠里,20,1999,2450,2555,5005
110,11,279,永和區,秀和里,21,2063,2342,2645,4987
110,11,280,淡水區,正德里,14,2168,2281,2693,4974
110,11,281,土城區,沛陂里,21,2001,2490,2472,4962
110,11,282,中和區,佳和里,40,2189,2336,2614,4950
110,11,283,樹林區,三興里,31,1819,2543,2404,4947
110,11,284,淡水區,新民里,12,2059,2343,2575,4918
110,11,285,新莊區,和平里,21,1782,2413,2502,4915
110,11,286,萬里區,萬里里,35,1492,2425,2483,4908
110,11,287,永和區,保平里,25,2002,2343,2559,4902
110,11,288,板橋區,長安里,19,1738,2375,2519,4894
110,11,289,永和區,和平里,24,2068,2315,2577,4892
110,11,290,永和區,豫溪里,17,2754,2511,2371,4882
110,11,291,新店區,中山里,26,2403,2213,2660,4873
110,11,292,中和區,景安里,44,2131,2359,2503,4862
110,11,293,汐止區,文化里,21,2064,2351,2510,4861
110,11,294,中和區,秀峰里,47,2412,2220,2621,4841
110,11,295,淡水區,學府里,18,2257,2279,2561,4840
110,11,296,板橋區,柏翠里,18,2192,2309,2529,4838
110,11,297,汐止區,智慧里,24,2244,2263,2572,4835
110,11,298,永和區,潭安里,20,2004,2319,2511,4830
110,11,299,永和區,永元里,21,1923,2263,2555,4818
110,11,300,中和區,秀福里,36,2008,2332,2481,4813
110,11,301,汐止區,東勢里,22,2426,2355,2455,4810
110,11,302,新莊區,四維里,22,1871,2294,2508,4802
110,11,303,新莊區,光正里,22,1619,2352,2445,4797
110,11,304,板橋區,埤墘里,17,1837,2273,2519,4792
110,11,305,板橋區,明翠里,22,1966,2328,2453,4781
110,11,306,永和區,民族里,22,1887,2263,2518,4781
110,11,307,新店區,吉祥里,24,1834,2255,2522,4777
110,11,308,汐止區,秀山里,26,1928,2362,2414,4776
110,11,309,汐止區,城中里,28,2041,2217,2556,4773
110,11,310,淡水區,沙崙里,8,2130,2348,2423,4771
110,11,311,汐止區,茄苳里,27,1795,2402,2366,4768
110,11,312,板橋區,港德里,29,1918,2332,2431,4763
110,11,313,五股區,興珍里,40,1695,2445,2318,4763
110,11,314,三重區,五常里,34,1750,2339,2413,4752
110,11,315,淡水區,民權里,17,2318,2185,2554,4739
110,11,316,板橋區,大豐里,22,1815,2284,2453,4737
110,11,317,土城區,日新里,27,1757,2337,2399,4736
110,11,318,土城區,貨饒里,22,1965,2314,2419,4733
110,11,319,三重區,福隆里,19,1843,2293,2434,4727
110,11,320,三重區,幸福里,36,1916,2308,2419,4727
110,11,321,新莊區,合鳳里,25,1730,2355,2369,4724
110,11,322,中和區,安穗里,19,1894,2272,2449,4721
110,11,323,中和區,壽德里,31,1859,2262,2451,4713
110,11,324,新莊區,光榮里,20,1570,2305,2407,4712
110,11,325,永和區,民樂里,22,1933,2291,2417,4708
110,11,326,板橋區,東丘里,20,1678,2286,2420,4706
110,11,327,汐止區,橫科里,42,2153,2318,2377,4695
110,11,328,中和區,忠孝里,39,1852,2307,2385,4692
110,11,329,樹林區,金寮里,24,1642,2308,2368,4676
110,11,330,永和區,潭墘里,25,1946,2127,2539,4666
110,11,331,五股區,德泰里,22,1764,2261,2401,4662
110,11,332,蘆洲區,永德里　,20,1586,2284,2372,4656
110,11,333,新莊區,中和里,30,1702,2275,2376,4651
110,11,334,永和區,民權里,26,1738,2205,2430,4635
110,11,335,新莊區,全安里,22,1817,2190,2440,4630
110,11,336,永和區,下溪里,15,1983,2214,2415,4629
110,11,337,三重區,博愛里,22,1655,2235,2394,4629
110,11,338,樹林區,圳福里,27,1621,2293,2330,4623
110,11,339,新莊區,恆安里,24,1686,2236,2369,4605
110,11,340,中和區,德穗里,32,1835,2203,2400,4603
110,11,341,泰山區,楓樹里,28,1753,2307,2295,4602
110,11,342,中和區,明穗里,33,1677,2313,2287,4600
110,11,343,汐止區,白雲里,26,1907,2293,2295,4588
110,11,344,板橋區,香社里,21,1798,2258,2313,4571
110,11,345,新莊區,中泰里,22,1771,2249,2321,4570
110,11,346,鶯歌區,鳳祥里,33,1662,2315,2244,4559
110,11,347,土城區,復興里,34,1712,2243,2303,4546
110,11,348,中和區,秀山里,31,1835,2179,2365,4544
110,11,349,鶯歌區,北鶯里,20,1997,2297,2232,4529
110,11,350,新莊區,昌隆里,15,1707,2130,2395,4525
110,11,351,土城區,永豐里,27,1656,2229,2295,4524
110,11,352,板橋區,莊敬里,17,1705,2137,2383,4520
110,11,353,板橋區,新民里,26,1734,2197,2314,4511
110,11,354,鶯歌區,鳳福里,29,1967,2216,2294,4510
110,11,355,土城區,員信里,25,1654,2218,2288,4506
110,11,356,土城區,延壽里,27,1721,2269,2214,4483
110,11,357,中和區,和興里,42,1943,2105,2371,4476
110,11,358,五股區,五股里,28,1959,2379,2097,4476
110,11,359,土城區,延吉里,22,1598,2238,2226,4464
110,11,360,八里區,埤頭里,28,1795,2228,2229,4457
110,11,361,中和區,廟美里,40,1777,2180,2276,4456
110,11,362,中和區,嘉慶里,24,1698,2172,2280,4452
110,11,363,新莊區,幸福里,30,1675,2115,2334,4449
110,11,364,三重區,光田里,27,1969,2140,2308,4448
110,11,365,金山區,美田里,25,1471,2099,2346,4445
110,11,366,板橋區,信義里,21,1777,2176,2268,4444
110,11,367,板橋區,堂春里,19,1532,2186,2252,4438
110,11,368,中和區,福美里,35,1720,2164,2274,4438
110,11,369,三重區,仁華里,27,1732,2142,2293,4435
110,11,370,林口區,菁湖里,23,1628,2194,2209,4403
110,11,371,板橋區,雙玉里,18,1601,2111,2274,4385
110,11,372,三重區,民生里,28,1767,2151,2231,4382
110,11,373,板橋區,振興里,17,1689,2133,2248,4381
110,11,374,五股區,集賢里,22,1578,2185,2190,4375
110,11,375,新店區,中華里,21,1988,2057,2305,4362
110,11,376,板橋區,忠誠里,17,1760,2083,2279,4362
110,11,377,新莊區,思賢里,21,1604,2156,2204,4360
110,11,378,板橋區,新生里,24,1594,2161,2192,4353
110,11,379,板橋區,漢生里,22,1695,2095,2247,4342
110,11,380,中和區,信和里,41,1652,2151,2188,4339
110,11,381,板橋區,僑中里,16,1565,2173,2165,4338
110,11,382,中和區,錦中里,22,1618,2115,2213,4328
110,11,383,永和區,得和里,25,1831,2022,2303,4325
110,11,384,板橋區,和平里,16,1749,2011,2308,4319
110,11,385,蘆洲區,延平里　,17,1585,2157,2161,4318
110,11,386,中和區,中安里,40,2102,1990,2325,4315
110,11,387,土城區,延祿里,21,1575,2138,2162,4300
110,11,388,淡水區,新義里,14,1561,2081,2210,4291
110,11,389,樹林區,樹南里,29,1575,2139,2144,4283
110,11,390,三重區,福德里,20,1812,2026,2257,4283
110,11,391,中和區,崇南里,41,1906,2048,2233,4281
110,11,392,中和區,安順里,34,1953,2018,2259,4277
110,11,393,林口區,麗園里,19,1561,2082,2193,4275
110,11,394,泰山區,同榮里,30,1533,2100,2172,4272
110,11,395,蘆洲區,中路里　,17,1549,2122,2149,4271
110,11,396,三重區,永安里,20,1544,2077,2194,4271
110,11,397,新店區,新和里,23,1783,2029,2239,4268
110,11,398,三峽區,大埔里,22,1517,2286,1980,4266
110,11,399,中和區,福善里,42,1863,1995,2261,4256
110,11,400,三峽區,八張里,20,1554,2094,2140,4234
110,11,401,中和區,東南里,32,1772,2037,2197,4234
110,11,402,板橋區,華興里,18,1696,2033,2194,4227
110,11,403,板橋區,振義里,19,1648,2076,2151,4227
110,11,404,永和區,永安里,24,1830,1944,2273,4217
110,11,405,蘆洲區,信義里　,27,1477,2103,2113,4216
110,11,406,中和區,福南里,29,1578,2034,2159,4193
110,11,407,板橋區,五權里,19,1581,2101,2089,4190
110,11,408,永和區,店街里,19,1880,1883,2303,4186
110,11,409,泰山區,貴子里,29,1663,2077,2091,4168
110,11,410,樹林區,三福里,32,1549,2067,2100,4167
110,11,411,永和區,秀林里,20,1683,2014,2152,4166
110,11,412,樹林區,光興里,21,1458,2098,2058,4156
110,11,413,中和區,民生里,30,1758,1998,2153,4151
110,11,414,永和區,民本里,17,1614,1947,2204,4151
110,11,415,三重區,田心里,32,1636,2040,2101,4141
110,11,416,新莊區,民有里,20,1577,1969,2169,4138
110,11,417,板橋區,廣福里,12,1580,2034,2102,4136
110,11,418,樹林區,三多里,21,1465,2111,2024,4135
110,11,419,永和區,民生里,22,1567,1936,2196,4132
110,11,420,林口區,東林里,27,1491,2087,2040,4127
110,11,421,新店區,福民里,25,1863,1929,2194,4123
110,11,422,板橋區,福祿里,19,1647,1946,2168,4114
110,11,423,瑞芳區,爪峯里,14,1609,2009,2104,4113
110,11,424,中和區,福真里,43,1736,2012,2099,4111
110,11,425,淡水區,中興里,18,1743,1993,2114,4107
110,11,426,蘆洲區,保新里　,12,1568,1996,2099,4095
110,11,427,板橋區,幸福里,19,1577,1996,2085,4081
110,11,428,中和區,嘉新里,22,1482,2014,2060,4074
110,11,429,中和區,明德里,28,1558,1994,2078,4072
110,11,430,泰山區,同興里,24,1448,1974,2098,4072
110,11,431,新店區,新安里,25,1947,1859,2206,4065
110,11,432,新店區,達觀里,21,2044,1867,2190,4057
110,11,433,三重區,五順里,35,1516,2003,2049,4052
110,11,434,板橋區,香丘里,14,1549,1928,2122,4050
110,11,435,板橋區,文聖里,17,1447,1968,2080,4048
110,11,436,板橋區,金華里,23,1497,1962,2086,4048
110,11,437,三重區,中興里,37,1662,2041,2001,4042
110,11,438,三重區,清和里,20,1943,1925,2116,4041
110,11,439,板橋區,大安里,24,1535,2057,1980,4037
110,11,440,三重區,五福里,17,1682,1935,2093,4028
110,11,441,五股區,六福里,23,1538,1958,2056,4014
110,11,442,板橋區,居仁里,17,1575,1985,2025,4010
110,11,443,新莊區,立志里,16,1541,1943,2059,4002
110,11,444,土城區,柑林里,21,1591,1902,2100,4002
110,11,445,永和區,雙和里,17,1722,1816,2179,3995
110,11,446,新莊區,昌信里,17,1480,1934,2056,3990
110,11,447,板橋區,公館里,21,1515,1974,2012,3986
110,11,448,五股區,集福里,26,1559,2014,1969,3983
110,11,449,中和區,仁和里,42,1456,1969,2009,3978
110,11,450,永和區,水源里,21,1634,1894,2082,3976
110,11,451,淡水區,幸福里,19,1602,1913,2060,3973
110,11,452,中和區,中正里,34,1556,1913,2052,3965
110,11,453,新莊區,化成里,15,1590,1980,1981,3961
110,11,454,三重區,崇德里,32,1561,1982,1978,3960
110,11,455,板橋區,文翠里,19,1543,1940,2017,3957
110,11,456,樹林區,和平里,28,1418,1958,1999,3957
110,11,457,中和區,漳和里,36,1766,1906,2048,3954
110,11,458,新店區,明德里,27,1805,1881,2065,3946
110,11,459,泰山區,明志里,24,1472,1929,2016,3945
110,11,460,新莊區,富民里,21,1526,1911,2018,3929
110,11,461,中和區,錦盛里,26,1470,1942,1980,3922
110,11,462,蘆洲區,保佑里　,18,1438,1940,1973,3913
110,11,463,永和區,秀朗里,23,1561,1896,1999,3895
110,11,464,新莊區,民全里,17,1384,1924,1962,3886
110,11,465,三重區,重明里,19,1610,1899,1983,3882
110,11,466,新店區,福德里,20,1634,1795,2084,3879
110,11,467,中和區,國光里,39,1507,1895,1970,3865
110,11,468,中和區,景文里,29,1672,1822,2034,3856
110,11,469,新店區,大同里,26,1746,1860,1986,3846
110,11,470,三重區,六合里,25,1525,1913,1928,3841
110,11,471,板橋區,吉翠里,16,1412,1859,1980,3839
110,11,472,五股區,民義里,23,1408,1932,1904,3836
110,11,473,中和區,秀水里,28,1593,1828,2001,3829
110,11,474,永和區,安和里,18,1726,1767,2061,3828
110,11,475,板橋區,鄉雲里,21,1677,1813,2015,3828
110,11,476,三重區,福樂里,23,1537,1861,1967,3828
110,11,477,新莊區,豐年里,16,1395,1879,1942,3821
110,11,478,板橋區,浮洲里,25,1447,1930,1884,3814
110,11,479,樹林區,圳安里,23,1369,1903,1906,3809
110,11,480,新店區,百忍里,22,1629,1754,2055,3809
110,11,481,泰山區,貴賢里,27,1512,1849,1956,3805
110,11,482,板橋區,永安里,17,1457,1838,1962,3800
110,11,483,板橋區,國泰里,15,1479,1805,1994,3799
110,11,484,新店區,小城里,18,1454,1850,1943,3793
110,11,485,永和區,桂林里,18,1537,1834,1956,3790
110,11,486,中和區,枋寮里,35,1564,1853,1935,3788
110,11,487,樹林區,樹興里,27,1408,1845,1939,3784
110,11,488,板橋區,後埔里,17,1608,1841,1942,3783
110,11,489,板橋區,大觀里,14,1336,1864,1919,3783
110,11,490,三重區,培德里,24,1428,1847,1935,3782
110,11,491,三峽區,中埔里,15,1407,1840,1935,3775
110,11,492,新莊區,萬安里,18,1469,1827,1946,3773
110,11,493,新店區,百福里,24,1685,1745,2016,3761
110,11,494,新莊區,仁義里,20,1430,1882,1877,3759
110,11,495,新莊區,立功里,25,1428,1825,1919,3744
110,11,496,新莊區,中宏里,20,1391,1836,1907,3743
110,11,497,泰山區,福興里,25,1412,1823,1920,3743
110,11,498,八里區,米倉里,24,1573,1912,1823,3735
110,11,499,板橋區,聯翠里,17,1670,1746,1983,3729
110,11,500,中和區,員富里,23,1529,1867,1856,3723
110,11,501,八里區,大崁里,17,1468,1907,1813,3720
110,11,502,汐止區,福山里,18,1773,1737,1980,3717
110,11,503,板橋區,廣新里,24,1295,1816,1899,3715
110,11,504,三峽區,二鬮里,24,1379,1866,1845,3711
110,11,505,新莊區,昌明里,18,1346,1817,1883,3700
110,11,506,板橋區,國光里,20,1546,1770,1928,3698
110,11,507,樹林區,大同里,18,1333,1759,1927,3686
110,11,508,新店區,大豐里,24,1589,1724,1959,3683
110,11,509,三重區,厚德里,22,1436,1822,1860,3682
110,11,510,鶯歌區,南靖里,20,1284,1884,1798,3682
110,11,511,永和區,竹林里,30,1546,1751,1921,3672
110,11,512,樹林區,樹德里,25,1398,1810,1856,3666
110,11,513,板橋區,溪北里,18,1361,1796,1847,3643
110,11,514,蘆洲區,復興里　,13,1310,1813,1830,3643
110,11,515,樹林區,樹福里,20,1462,1750,1888,3638
110,11,516,瑞芳區,新峰里,14,1377,1826,1811,3637
110,11,517,新莊區,中全里,18,1326,1837,1799,3636
110,11,518,土城區,學府里,22,1257,1735,1900,3635
110,11,519,泰山區,黎明里,17,1330,1772,1855,3627
110,11,520,三重區,重陽里,25,1430,1787,1839,3626
110,11,521,板橋區,華翠里,19,1377,1756,1854,3610
110,11,522,中和區,福和里,32,1480,1781,1829,3610
110,11,523,土城區,廣興里,18,1342,1711,1893,3604
110,11,524,五股區,五福里,23,1321,1845,1757,3602
110,11,525,五股區,福德里,19,1427,1782,1799,3581
110,11,526,五股區,成德里,23,1364,1783,1793,3576
110,11,527,板橋區,建國里,31,1434,1705,1868,3573
110,11,528,板橋區,福星里,20,1367,1686,1873,3559
110,11,529,中和區,景新里,32,1493,1686,1873,3559
110,11,530,萬里區,野柳里,19,1105,1693,1864,3557
110,11,531,新店區,明城里,21,1403,1710,1834,3544
110,11,532,中和區,安樂里,33,1610,1642,1899,3541
110,11,533,深坑區,深坑里,41,1497,1722,1804,3526
110,11,534,板橋區,新海里,21,1254,1764,1760,3524
110,11,535,樹林區,樹人里,21,1252,1705,1805,3510
110,11,536,中和區,建和里,34,1418,1689,1820,3509
110,11,537,樹林區,中華里,19,1232,1673,1836,3509
110,11,538,汐止區,橋東里,20,1455,1660,1843,3503
110,11,539,三重區,慈愛里,25,1362,1712,1785,3497
110,11,540,永和區,上林里,21,1481,1697,1797,3494
110,11,541,新莊區,文聖里,29,1405,1634,1856,3490
110,11,542,中和區,國華里,22,1371,1721,1768,3489
110,11,543,三重區,福民里,19,1340,1709,1780,3489
110,11,544,三重區,福田里,24,1261,1748,1730,3478
110,11,545,三重區,立德里,22,1323,1699,1775,3474
110,11,546,中和區,秀成里,31,1355,1700,1772,3472
110,11,547,三重區,三民里,15,1302,1729,1739,3468
110,11,548,永和區,河堤里,19,1565,1643,1818,3461
110,11,549,中和區,泰安里,42,1451,1637,1820,3457
110,11,550,中和區,秀仁里,23,1487,1670,1786,3456
110,11,551,中和區,正南里,30,1367,1755,1700,3455
110,11,552,板橋區,景星里,24,1563,1674,1778,3452
110,11,553,蘆洲區,中華里　,14,1296,1669,1774,3443
110,11,554,板橋區,朝陽里,16,1297,1635,1807,3442
110,11,555,三重區,富華里,24,1383,1705,1730,3435
110,11,556,板橋區,文化里,17,1408,1651,1772,3423
110,11,557,蘆洲區,得勝里　,21,1317,1670,1746,3416
110,11,558,板橋區,松翠里,18,1426,1633,1780,3413
110,11,559,板橋區,光復里,25,1372,1724,1681,3405
110,11,560,汐止區,福德里,18,1575,1623,1782,3405
110,11,561,蘆洲區,忠義里　,14,1239,1643,1747,3390
110,11,562,永和區,智光里,32,1385,1612,1777,3389
110,11,563,新莊區,興漢里,32,1356,1651,1737,3388
110,11,564,永和區,福林里,25,1431,1614,1766,3380
110,11,565,土城區,中正里,18,1274,1604,1775,3379
110,11,566,土城區,學成里,18,1199,1652,1715,3367
110,11,567,三重區,龍濱里,20,1302,1643,1711,3354
110,11,568,新店區,下城里,14,1388,1700,1646,3346
110,11,569,永和區,永貞里,20,1418,1587,1759,3346
110,11,570,三重區,永盛里,25,1255,1621,1716,3337
110,11,571,蘆洲區,福安里　,11,1206,1652,1685,3337
110,11,572,泰山區,新明里,25,1208,1643,1694,3337
110,11,573,土城區,青雲里,21,1277,1604,1727,3331
110,11,574,瑞芳區,吉安里,16,1295,1682,1639,3321
110,11,575,樹林區,育英里,20,1276,1621,1687,3308
110,11,576,汐止區,忠山里,22,1580,1574,1731,3305
110,11,577,板橋區,福壽里,16,1302,1609,1693,3302
110,11,578,樹林區,東山里,20,1159,1683,1616,3299
110,11,579,蘆洲區,樹德里　,14,1260,1651,1634,3285
110,11,580,中和區,冠穗里,24,1279,1628,1652,3280
110,11,581,新店區,復興里,21,1447,1549,1724,3273
110,11,582,板橋區,新興里,17,1570,1552,1716,3268
110,11,583,永和區,河濱里,19,1324,1594,1667,3261
110,11,584,三重區,仁忠里,23,1273,1599,1662,3261
110,11,585,蘆洲區,溪墘里　,15,1229,1574,1675,3249
110,11,586,中和區,清穗里,24,1289,1600,1628,3228
110,11,587,新店區,百和里,22,1389,1546,1672,3218
110,11,588,永和區,永興里,26,1305,1513,1687,3200
110,11,589,汐止區,興福里,20,1466,1528,1670,3198
110,11,590,板橋區,介壽里,17,1272,1514,1672,3186
110,11,591,永和區,中興里,17,1459,1468,1716,3184
110,11,592,土城區,頂新里,10,1283,1509,1651,3160
110,11,593,三峽區,溪東里,16,1090,1610,1543,3153
110,11,594,中和區,安和里,27,1400,1497,1650,3147
110,11,595,新莊區,八德里,16,1202,1519,1627,3146
110,11,596,新店區,國豐里,22,1374,1442,1704,3146
110,11,597,深坑區,土庫里,36,1221,1589,1551,3140
110,11,598,永和區,秀元里,20,1234,1492,1648,3140
110,11,599,中和區,景南里,34,1308,1498,1639,3137
110,11,600,土城區,瑞興里,26,1241,1528,1603,3131
110,11,601,新莊區,後德里,15,1115,1580,1549,3129
110,11,602,新店區,太平里,20,1434,1454,1672,3126
110,11,603,新店區,粗坑里,20,1356,1496,1626,3122
110,11,604,土城區,青山里,18,1081,1558,1562,3120
110,11,605,三重區,尚德里,29,1215,1489,1619,3108
110,11,606,蘆洲區,得仁里　,15,1161,1517,1585,3102
110,11,607,新店區,建國里,18,1348,1434,1655,3089
110,11,608,新莊區,民本里,19,1159,1540,1534,3074
110,11,609,板橋區,文德里,12,1239,1505,1567,3072
110,11,610,板橋區,仁愛里,20,1168,1515,1556,3071
110,11,611,板橋區,正泰里,16,1132,1471,1598,3069
110,11,612,萬里區,北基里,23,1462,1509,1553,3062
110,11,613,中和區,吉興里,21,1331,1367,1691,3058
110,11,614,五股區,貿商里,25,1232,1459,1595,3054
110,11,615,永和區,民富里,15,1129,1497,1556,3053
110,11,616,中和區,興南里,37,1262,1487,1564,3051
110,11,617,板橋區,滿翠里,20,1170,1460,1588,3048
110,11,618,三重區,福安里,25,1244,1496,1547,3043
110,11,619,萬里區,大鵬里,24,1014,1522,1494,3016
110,11,620,板橋區,百壽里,17,1244,1388,1619,3007
110,11,621,板橋區,青翠里,15,1206,1511,1494,3005
110,11,622,汐止區,宜興里,25,1484,1393,1601,2994
110,11,623,三重區,維德里,21,1168,1477,1511,2988
110,11,624,汐止區,山光里,14,1318,1449,1534,2983
110,11,625,淡水區,北新里,20,1448,1444,1538,2982
110,11,626,三重區,永吉里,20,1169,1432,1543,2975
110,11,627,中和區,正行里,19,1257,1379,1594,2973
110,11,628,永和區,民治里,24,1257,1333,1637,2970
110,11,629,永和區,協和里,22,1291,1437,1522,2959
110,11,630,永和區,光明里,17,1290,1327,1631,2958
110,11,631,汐止區,保新里,13,1444,1465,1492,2957
110,11,632,新莊區,中華里,15,1224,1474,1480,2954
110,11,633,板橋區,港尾里,15,1111,1423,1529,2952
110,11,634,板橋區,九如里,16,1112,1445,1502,2947
110,11,635,板橋區,長壽里,11,1104,1449,1497,2946
110,11,636,板橋區,光仁里,15,1030,1451,1493,2944
110,11,637,中和區,頂南里,26,1105,1433,1511,2944
110,11,638,樹林區,圳民里,16,1133,1538,1400,2938
110,11,639,汐止區,大同里,23,1297,1367,1558,2925
110,11,640,中和區,嘉穗里,15,1062,1444,1473,2917
110,11,641,永和區,秀成里,17,1193,1432,1473,2905
110,11,642,泰山區,福泰里,25,1048,1476,1428,2904
110,11,643,新莊區,光和里,19,971,1402,1494,2896
110,11,644,板橋區,仁翠里,16,1109,1414,1474,2888
110,11,645,三重區,大園里,22,1162,1430,1447,2877
110,11,646,板橋區,莒光里,17,1154,1391,1483,2874
110,11,647,樹林區,太順里,16,939,1465,1394,2859
110,11,648,板橋區,龍安里,20,1082,1398,1452,2850
110,11,649,萬里區,龜吼里,20,1011,1438,1401,2839
110,11,650,烏來區,烏來里,15,903,1381,1454,2835
110,11,651,永和區,文化里,18,1224,1342,1480,2822
110,11,652,板橋區,西安里,14,1071,1362,1457,2819
110,11,653,新店區,華城里,13,1330,1312,1507,2819
110,11,654,板橋區,香雅里,11,1189,1378,1439,2817
110,11,655,汐止區,湖蓮里,12,1514,1304,1505,2809
110,11,656,中和區,中山里,22,1095,1335,1458,2793
110,11,657,板橋區,自立里,20,1102,1328,1443,2771
110,11,658,三重區,中山里,22,1216,1359,1406,2765
110,11,659,永和區,秀得里,20,1071,1310,1454,2764
110,11,660,永和區,永福里,18,1133,1306,1447,2753
110,11,661,新店區,忠孝里,15,1310,1312,1438,2750
110,11,662,新店區,美城里,14,1101,1330,1419,2749
110,11,663,深坑區,萬福里,30,1249,1383,1363,2746
110,11,664,中和區,秀義里,18,1111,1343,1389,2732
110,11,665,中和區,民有里,24,1113,1339,1390,2729
110,11,666,三重區,三安里,20,1245,1312,1415,2727
110,11,667,三重區,光正里,22,1342,1309,1415,2724
110,11,668,蘆洲區,民和里　,15,1054,1348,1373,2721
110,11,669,新店區,新德里,20,1273,1268,1448,2716
110,11,670,三重區,頂崁里,28,1119,1367,1345,2712
110,11,671,板橋區,光華里,20,1133,1319,1390,2709
110,11,672,新莊區,仁愛里,20,1058,1311,1392,2703
110,11,673,永和區,仁愛里,17,1176,1291,1404,2695
110,11,674,淡水區,義山里,19,1096,1435,1259,2694
110,11,675,三重區,國隆里,26,1128,1320,1373,2693
110,11,676,板橋區,陽明里,17,1040,1305,1385,2690
110,11,677,板橋區,民權里,24,1094,1285,1380,2665
110,11,678,新店區,大鵬里,10,1277,1283,1378,2661
110,11,679,蘆洲區,保和里　,15,1002,1305,1356,2661
110,11,680,新莊區,自強里,15,1113,1315,1334,2649
110,11,681,永和區,大新里,16,1220,1189,1455,2644
110,11,682,板橋區,光榮里,20,1042,1334,1289,2623
110,11,683,新莊區,立德里,17,1017,1263,1343,2606
110,11,684,三重區,慈化里,17,958,1256,1348,2604
110,11,685,八里區,頂罟里,13,1089,1307,1296,2603
110,11,686,新店區,國校里,10,1129,1284,1318,2602
110,11,687,板橋區,東安里,11,890,1260,1336,2596
110,11,688,新莊區,祥鳳里,18,934,1280,1313,2593
110,11,689,永和區,信義里,15,1223,1166,1425,2591
110,11,690,五股區,陸一里,35,1091,1260,1329,2589
110,11,691,新莊區,泰豐里,14,1057,1243,1346,2589
110,11,692,板橋區,華貴里,19,994,1247,1334,2581
110,11,693,深坑區,萬順里,24,1120,1273,1283,2556
110,11,694,新店區,長春里,11,1136,1177,1363,2540
110,11,695,蘆洲區,忠孝里　,12,875,1246,1280,2526
110,11,696,三重區,永煇里,16,970,1283,1235,2518
110,11,697,新莊區,自信里,12,977,1207,1308,2515
110,11,698,三重區,瑞德里,19,940,1235,1263,2498
110,11,699,中和區,壽南里,23,1049,1240,1247,2487
110,11,700,中和區,民享里,20,920,1218,1266,2484
110,11,701,新莊區,建福里,13,904,1240,1241,2481
110,11,702,永和區,頂溪里,16,1062,1167,1314,2481
110,11,703,三重區,長元里,18,1047,1270,1210,2480
110,11,704,新店區,屈尺里,18,901,1261,1219,2480
110,11,705,中和區,瑞穗里,18,1005,1146,1330,2476
110,11,706,中和區,秀士里,22,1073,1175,1293,2468
110,11,707,新店區,忠誠里,20,1099,1196,1271,2467
110,11,708,新莊區,福營里,20,1071,1228,1233,2461
110,11,709,新店區,文明里,18,1066,1177,1283,2460
110,11,710,板橋區,嵐翠里,12,968,1233,1215,2448
110,11,711,永和區,復興里,14,1036,1174,1251,2425
110,11,712,永和區,永樂里,16,1092,1082,1331,2413
110,11,713,新莊區,龍安里,15,864,1184,1226,2410
110,11,714,中和區,連和里,26,1243,1096,1310,2406
110,11,715,三峽區,溪北里,20,903,1260,1140,2400
110,11,716,新店區,張南里,10,1289,1031,1336,2367
110,11,717,三重區,錦江里,20,959,1171,1193,2364
110,11,718,深坑區,賴仲里,26,1074,1191,1162,2353
110,11,719,新莊區,富國里,14,915,1172,1164,2336
110,11,720,三峽區,嘉添里,21,809,1326,1009,2335
110,11,721,板橋區,民生里,14,937,1116,1219,2335
110,11,722,汐止區,鄉長里,15,914,1175,1142,2317
110,11,723,三重區,菜寮里,19,943,1118,1199,2317
110,11,724,三重區,慈生里,20,889,1139,1174,2313
110,11,725,板橋區,富貴里,10,887,1113,1198,2311
110,11,726,中和區,錦昌里,13,969,1174,1132,2306
110,11,727,三重區,光華里,17,1111,1085,1212,2297
110,11,728,鶯歌區,西鶯里,18,880,1132,1162,2294
110,11,729,三重區,福利里,16,1041,1063,1231,2294
110,11,730,三重區,慈惠里,15,932,1148,1144,2292
110,11,731,三重區,順德里,23,890,1162,1123,2285
110,11,732,板橋區,松柏里,12,929,1105,1177,2282
110,11,733,新莊區,龍福里,13,866,1085,1192,2277
110,11,734,三重區,慈福里,17,950,1149,1124,2273
110,11,735,石門區,老梅里,19,837,1161,1103,2264
110,11,736,三重區,文化里,28,938,1139,1122,2261
110,11,737,樹林區,北園里,12,770,1178,1068,2246
110,11,738,三重區,長泰里,20,939,1118,1110,2228
110,11,739,永和區,新廍里,18,998,1096,1126,2222
110,11,740,新莊區,文衡里,16,865,1087,1128,2215
110,11,741,板橋區,民安里,19,876,1032,1176,2208
110,11,742,新莊區,中誠里,15,882,1091,1117,2208
110,11,743,蘆洲區,仁復里　,11,867,1087,1118,2205
110,11,744,瑞芳區,龍興里,13,966,1078,1111,2189
110,11,745,汐止區,樟樹里,14,955,1146,1032,2178
110,11,746,淡水區,水源里,22,895,1152,1026,2178
110,11,747,永和區,正興里,17,1009,995,1176,2171
110,11,748,深坑區,昇高里,16,795,1137,1033,2170
110,11,749,三重區,長安里,22,890,1057,1111,2168
110,11,750,土城區,土城里,19,890,1043,1124,2167
110,11,751,三重區,錦田里,15,872,1073,1089,2162
110,11,752,瑞芳區,傑魚里,10,793,1124,1038,2162
110,11,753,貢寮區,真理里,22,723,1051,1104,2155
110,11,754,樹林區,三龍里,16,778,1115,1039,2154
110,11,755,永和區,前溪里,13,990,993,1160,2153
110,11,756,三重區,富福里,20,810,1017,1134,2151
110,11,757,三芝區,後厝里,27,1144,1067,1078,2145
110,11,758,瑞芳區,瑞濱里,13,1073,1028,1098,2126
110,11,759,樹林區,樂山里,15,748,1074,1043,2117
110,11,760,板橋區,新埔里,13,888,1017,1080,2097
110,11,761,三重區,信安里,18,931,1005,1090,2095
110,11,762,土城區,長風里,14,809,1003,1090,2093
110,11,763,泰山區,泰友里,18,757,1016,1074,2090
110,11,764,中和區,景本里,22,891,999,1088,2087
110,11,765,三重區,安慶里,16,901,977,1101,2078
110,11,766,三重區,長江里,17,889,1010,1064,2074
110,11,767,三峽區,竹崙里,20,902,1151,910,2061
110,11,768,三重區,大同里,17,938,974,1052,2026
110,11,769,新店區,仁愛里,19,951,948,1069,2017
110,11,770,板橋區,華福里,13,760,971,1039,2010
110,11,771,新莊區,立人里,9,764,982,1026,2008
110,11,772,三重區,正安里,16,850,965,1040,2005
110,11,773,三重區,仁德里,20,910,983,1008,1991
110,11,774,三重區,萬壽里,20,816,969,1022,1991
110,11,775,永和區,後溪里,13,867,975,1001,1976
110,11,776,板橋區,挹秀里,13,861,962,1013,1975
110,11,777,淡水區,埤島里,13,870,1030,927,1957
110,11,778,三重區,永春里,14,795,951,993,1944
110,11,779,三重區,五谷里,25,863,984,939,1923
110,11,780,三重區,中央里,19,881,935,978,1913
110,11,781,中和區,宜安里,17,859,933,979,1912
110,11,782,三重區,龍門里,20,800,938,971,1909
110,11,783,八里區,荖阡里,12,640,989,914,1903
110,11,784,金山區,磺港里,20,557,959,939,1898
110,11,785,烏來區,忠治里,7,558,916,971,1887
110,11,786,永和區,上溪里,20,903,863,1020,1883
110,11,787,樹林區,西園里,14,657,991,880,1871
110,11,788,汐止區,仁德里,17,859,898,968,1866
110,11,789,新莊區,文德里,18,747,917,946,1863
110,11,790,貢寮區,仁里里,16,666,921,939,1860
110,11,791,三重區,自強里,16,766,893,966,1859
110,11,792,瑞芳區,東和里,14,712,917,932,1849
110,11,793,金山區,五湖里,17,615,952,896,1848
110,11,794,三重區,正義里,14,767,943,905,1848
110,11,795,瑞芳區,吉慶里,18,717,966,881,1847
110,11,796,三重區,忠孝里,19,776,906,933,1839
110,11,797,三重區,錦安里,22,781,874,965,1839
110,11,798,新店區,新店里,16,838,901,928,1829
110,11,799,淡水區,文化里,14,804,840,986,1826
110,11,800,瑞芳區,龍川里,11,737,878,938,1816
110,11,801,三重區,承德里,20,654,914,899,1813
110,11,802,三重區,同慶里,17,748,885,923,1808
110,11,803,林口區,太平里,15,675,879,912,1791
110,11,804,八里區,下罟里,12,564,897,886,1783
110,11,805,新店區,文中里,14,819,867,915,1782
110,11,806,八里區,長坑里,14,498,939,836,1775
110,11,807,新莊區,文明里,16,666,870,903,1773
110,11,808,樹林區,坡內里,15,606,899,864,1763
110,11,809,三重區,奕壽里,15,781,836,914,1750
110,11,810,永和區,光復里,16,783,800,949,1749
110,11,811,新莊區,營盤里,19,723,899,849,1748
110,11,812,樹林區,東園里,14,673,930,816,1746
110,11,813,貢寮區,福隆里,22,648,845,881,1726
110,11,814,新店區,龜山里,13,718,874,852,1726
110,11,815,石門區,石門里,14,674,869,826,1695
110,11,816,汐止區,保安里,15,675,851,838,1689
110,11,817,鶯歌區,同慶里,14,619,832,855,1687
110,11,818,三重區,大安里,15,684,842,841,1683
110,11,819,土城區,祖田里,10,598,866,815,1681
110,11,820,汐止區,長安里,15,706,826,845,1671
110,11,821,新店區,頂城里,18,709,886,782,1668
110,11,822,板橋區,留侯里,10,688,792,870,1662
110,11,823,淡水區,興仁里,14,682,880,759,1639
110,11,824,石門區,尖鹿里,16,634,867,766,1633
110,11,825,三重區,二重里,15,584,829,800,1629
110,11,826,土城區,清化里,17,633,857,761,1618
110,11,827,淡水區,賢孝里,14,648,867,739,1606
110,11,828,三重區,開元里,20,749,802,798,1600
110,11,829,三重區,長福里,20,669,760,832,1592
110,11,830,林口區,湖北里,14,494,859,728,1587
110,11,831,樹林區,圳生里,11,570,820,760,1580
110,11,832,汐止區,烘內里,21,774,824,750,1574
110,11,833,三峽區,溪南里,16,548,868,687,1555
110,11,834,三重區,光輝里,18,630,774,779,1553
110,11,835,雙溪區,牡丹里,38,690,825,721,1546
110,11,836,三重區,重新里,19,679,751,788,1539
110,11,837,淡水區,協元里,10,615,749,760,1509
110,11,838,三重區,平和里,18,642,774,728,1502
110,11,839,三重區,永興里,17,759,697,804,1501
110,11,840,坪林區,坪林里,12,497,796,701,1497
110,11,841,淡水區,樹興里,12,753,780,717,1497
110,11,842,板橋區,流芳里,10,631,684,801,1485
110,11,843,三重區,同安里,19,615,743,730,1473
110,11,844,石門區,富基里,15,542,714,754,1468
110,11,845,三重區,錦通里,16,646,702,761,1463
110,11,846,瑞芳區,龍山里,11,595,776,685,1461
110,11,847,新店區,和平里,11,668,719,737,1456
110,11,848,淡水區,長庚里,29,649,700,748,1448
110,11,849,新莊區,國泰里,16,536,729,715,1444
110,11,850,林口區,下福里,20,493,753,689,1442
110,11,851,三峽區,安坑里,16,579,816,625,1441
110,11,852,三重區,光榮里,17,678,702,739,1441
110,11,853,三重區,吉利里,12,648,707,723,1430
110,11,854,瑞芳區,深澳里,15,694,672,753,1425
110,11,855,五股區,五龍里,17,478,782,628,1410
110,11,856,瑞芳區,上天里,12,542,751,649,1400
110,11,857,五股區,觀音里,17,523,769,630,1399
110,11,858,新店區,廣興里,17,601,758,638,1396
110,11,859,板橋區,福翠里,16,575,693,697,1390
110,11,860,三重區,仁義里,17,593,691,686,1377
110,11,861,三重區,中正里,13,567,669,707,1376
110,11,862,汐止區,義民里,20,640,671,704,1375
110,11,863,淡水區,坪頂里,10,627,686,677,1363
110,11,864,瑞芳區,海濱里,13,688,634,700,1334
110,11,865,瑞芳區,龍鎮里,15,572,649,671,1320
110,11,866,板橋區,黃石里,10,533,627,675,1302
110,11,867,三重區,秀江里,15,507,647,653,1300
110,11,868,新店區,直潭里,22,490,688,608,1296
110,11,869,三芝區,興華里,20,543,700,585,1285
110,11,870,坪林區,大林里,10,481,706,566,1272
110,11,871,萬里區,中幅里,13,373,631,636,1267
110,11,872,雙溪區,泰平里,20,414,639,628,1267
110,11,873,汐止區,環河里,10,542,676,588,1264
110,11,874,三重區,中民里,17,518,642,617,1259
110,11,875,板橋區,歡園里,8,470,654,598,1252
110,11,876,金山區,重和里,13,561,619,628,1247
110,11,877,石門區,德茂里,14,446,655,584,1239
110,11,878,永和區,勵行里,17,574,571,663,1234
110,11,879,三芝區,古庄里,19,609,644,570,1214
110,11,880,三重區,福星里,17,614,561,649,1210
110,11,881,五股區,更寮里,11,429,637,570,1207
110,11,882,樹林區,樹東里,16,554,578,628,1206
110,11,883,瑞芳區,柑坪里,16,428,629,572,1201
110,11,884,永和區,網溪里,12,500,591,600,1191
110,11,885,三重區,介壽里,13,513,581,603,1184
110,11,886,淡水區,忠寮里,13,432,660,522,1182
110,11,887,三峽區,弘道里,14,418,668,509,1177
110,11,888,淡水區,清文里,25,487,600,575,1175
110,11,889,三峽區,添福里,9,436,618,550,1168
110,11,890,林口區,頂福里,20,414,636,519,1155
110,11,891,三重區,正德里,16,512,574,576,1150
110,11,892,汐止區,禮門里,17,541,554,595,1149
110,11,893,淡水區,屯山里,13,364,596,512,1108
110,11,894,石碇區,格頭里,13,532,572,533,1105
110,11,895,鶯歌區,中鶯里,16,406,547,542,1089
110,11,896,鶯歌區,東鶯里,14,413,543,542,1085
110,11,897,淡水區,蕃薯里,10,514,620,455,1075
110,11,898,萬里區,雙興里,15,405,581,489,1070
110,11,899,永和區,大同里,18,498,519,539,1058
110,11,900,林口區,嘉寶里,20,377,570,486,1056
110,11,901,新店區,塗潭里,11,361,547,502,1049
110,11,902,板橋區,赤松里,8,478,486,544,1030
110,11,903,石門區,草里里,12,378,527,501,1028
110,11,904,貢寮區,和美里,21,354,527,499,1026
110,11,905,汐止區,八連里,10,461,546,470,1016
110,11,906,三重區,谷王里,15,403,532,475,1007
110,11,907,鶯歌區,二甲里,8,342,528,449,977
110,11,908,永和區,永成里,19,410,478,496,974
110,11,909,三峽區,成福里,16,323,523,449,972
110,11,910,板橋區,復興里,8,273,593,374,967
110,11,911,三重區,雙園里,13,412,465,497,962
110,11,912,雙溪區,平林里,14,440,525,434,959
110,11,913,樹林區,樹北里,18,440,465,486,951
110,11,914,泰山區,大科里,16,332,515,434,949
110,11,915,石碇區,永安里,6,398,478,460,938
110,11,916,石門區,山溪里,16,359,524,412,936
110,11,917,汐止區,長青里,10,535,435,495,930
110,11,918,坪林區,粗窟里,11,365,509,418,927
110,11,919,永和區,新生里,18,431,455,470,925
110,11,920,貢寮區,福連里,16,305,425,498,923
110,11,921,淡水區,永吉里,22,406,452,453,905
110,11,922,坪林區,上德里,13,344,513,390,903
110,11,923,瑞芳區,鼻頭里,11,256,451,452,903
110,11,924,林口區,瑞平里,10,328,502,399,901
110,11,925,三重區,長生里,10,392,442,457,899
110,11,926,坪林區,漁光里,13,397,472,422,894
110,11,927,金山區,清泉里,10,291,473,418,891
110,11,928,淡水區,忠山里,10,363,488,401,889
110,11,929,貢寮區,貢寮里,16,371,434,448,882
110,11,930,石碇區,潭邊里,10,422,462,409,871
110,11,931,平溪區,十分里,10,432,470,396,866
110,11,932,三重區,大德里,11,356,409,454,863
110,11,933,三峽區,五寮里,15,360,468,392,860
110,11,934,三芝區,福德里,18,374,443,415,858
110,11,935,三芝區,新庄里,12,351,449,408,857
110,11,936,新店區,廣明里,13,416,423,428,851
110,11,937,新店區,雙坑里,15,310,453,363,816
110,11,938,瑞芳區,龍潭里,13,367,403,411,814
110,11,939,中和區,灰磘里,7,257,429,381,810
110,11,940,烏來區,福山里,6,212,402,402,804
110,11,941,雙溪區,新基里,17,350,425,372,797
110,11,942,石碇區,中民里,14,339,459,328,787
110,11,943,永和區,忠義里,16,300,387,381,768
110,11,944,金山區,大同里,9,280,360,398,758
110,11,945,貢寮區,美豐里,21,301,441,315,756
110,11,946,淡水區,草東里,24,334,379,362,741
110,11,947,石碇區,隆盛里,12,301,415,323,738
110,11,948,三峽區,有木里,14,359,433,286,719
110,11,949,三芝區,錫板里,17,300,418,294,712
110,11,950,雙溪區,魚行里,29,349,403,308,711
110,11,951,金山區,六股里,8,240,384,327,711
110,11,952,萬里區,溪底里,9,285,386,316,702
110,11,953,淡水區,民安里,24,287,329,370,699
110,11,954,坪林區,水德里,10,285,370,322,692
110,11,955,三峽區,插角里,16,357,411,279,690
110,11,956,瑞芳區,龍安里,11,282,342,342,684
110,11,957,三峽區,秀川里,10,286,331,352,683
110,11,958,貢寮區,龍門里,14,245,328,345,673
110,11,959,金山區,三界里,10,203,312,355,667
110,11,960,貢寮區,雙玉里,23,285,388,277,665
110,11,961,三芝區,茂長里,9,299,340,316,656
110,11,962,石碇區,永定里,10,267,356,294,650
110,11,963,萬里區,磺潭里,14,235,347,302,649
110,11,964,石碇區,烏塗里,10,326,373,269,642
110,11,965,雙溪區,上林里,20,293,364,270,634
110,11,966,汐止區,東山里,20,281,327,299,626
110,11,967,平溪區,嶺腳里,10,298,343,283,626
110,11,968,深坑區,阿柔里,9,225,347,277,624
110,11,969,石門區,茂林里,11,208,335,288,623
110,11,970,淡水區,中和里,11,220,356,263,619
110,11,971,三芝區,店子里,14,255,340,275,615
110,11,972,金山區,永興里,15,233,323,290,613
110,11,973,鶯歌區,建德里,8,218,337,269,606
110,11,974,烏來區,信賢里,9,197,284,312,596
110,11,975,三芝區,圓山里,12,213,327,254,581
110,11,976,金山區,豐漁里,9,171,290,277,567
110,11,977,三峽區,金圳里,12,229,318,220,538
110,11,978,三芝區,橫山里,19,224,295,216,511
110,11,979,金山區,和平里,8,190,244,254,498
110,11,980,金山區,萬壽里,8,183,237,259,496
110,11,981,雙溪區,雙溪里,19,224,244,243,487
110,11,982,貢寮區,吉林里,19,249,298,183,481
110,11,983,瑞芳區,濂洞里,20,251,221,257,478
110,11,984,瑞芳區,猴硐里,12,198,263,212,475
110,11,985,平溪區,石底里,10,211,233,217,450
110,11,986,瑞芳區,永慶里,13,226,236,211,447
110,11,987,瑞芳區,基山里,15,213,230,216,446
110,11,988,坪林區,石𥕢里,9,196,236,209,445
110,11,989,萬里區,崁脚里,14,172,222,221,443
110,11,990,平溪區,東勢里,10,244,253,178,431
110,11,991,石碇區,豐田里,7,211,246,180,426
110,11,992,貢寮區,龍崗里,12,179,243,181,424
110,11,993,淡水區,新生里,13,220,185,236,421
110,11,994,石碇區,石碇里,9,172,224,195,419
110,11,995,雙溪區,外柑里,17,216,240,169,409
110,11,996,金山區,兩湖里,7,137,222,184,406
110,11,997,平溪區,薯榔里,10,203,223,164,387
110,11,998,三重區,德厚里,6,171,178,199,377
110,11,999,雙溪區,共和里,13,184,196,174,370
110,11,1000,雙溪區,長源里,20,188,218,150,368
110,11,1001,瑞芳區,新山里,11,178,198,167,365
110,11,1002,雙溪區,三港里,17,176,213,151,364
110,11,1003,汐止區,信望里,14,165,188,160,348
110,11,1004,平溪區,南山里,9,191,209,135,344
110,11,1005,瑞芳區,頌德里,10,173,181,160,341
110,11,1006,雙溪區,三貂里,20,151,189,143,332
110,11,1007,石碇區,豐林里,5,118,179,152,331
110,11,1008,中和區,橫路里,7,124,169,159,328
110,11,1009,三芝區,八賢里,10,135,182,146,328
110,11,1010,瑞芳區,石山里,13,178,178,150,328
110,11,1011,三峽區,三峽里,10,126,186,138,324
110,11,1012,石碇區,彭山里,6,159,181,142,323
110,11,1013,石門區,乾華里,7,145,186,136,322
110,11,1014,瑞芳區,崇文里,10,162,160,147,307
110,11,1015,瑞芳區,濂新里,10,128,143,160,303
110,11,1016,鶯歌區,東湖里,10,134,151,129,280
110,11,1017,石碇區,光明里,5,143,156,117,273
110,11,1018,瑞芳區,弓橋里,8,130,155,117,272
110,11,1019,瑞芳區,南雅里,9,93,139,130,269
110,11,1020,平溪區,平溪里,10,128,149,117,266
110,11,1021,瑞芳區,光復里,14,131,142,108,250
110,11,1022,平溪區,菁桐里,11,124,138,111,249
110,11,1023,平溪區,白石里,13,114,135,113,248
110,11,1024,烏來區,孝義里,6,46,133,114,247
110,11,1025,瑞芳區,銅山里,12,97,105,79,184
110,11,1026,金山區,西湖里,7,58,109,73,182
110,11,1027,瑞芳區,福住里,8,91,95,77,172
110,11,1028,瑞芳區,瓜山里,11,98,84,85,169
110,11,1029,平溪區,平湖里,10,85,86,77,163
110,11,1030,平溪區,新寮里,9,92,100,62,162
110,11,1031,平溪區,望古里,8,98,87,62,149
110,11,1032,瑞芳區,碩仁里,10,73,77,58,135
總計,,,,,22376,1620714,1958931,2052655,4011586